
( => (
) => )
+ => +
, => ,
. => .
10 => 10
11 => 11
1st => 1st
6 => 6
A1 => A1
Alex => Alex
Alice => Alice
Ann/Anna => Ann/Anna
Aâ€ => Aâ€
B => B
Ben => Ben
Bill => Bill
C => C
CD => CD
Charlie => Charlie
Clare => Clare
D => D
DVD => DVD
Daisy => Daisy
Dan => Dan
E => E
English => English
Eva => Eva
F => F
Fred => Fred
Friday => Friday
G => G
Grace => Grace
Grammatical => Grammatical
H => H
Hugo => Hugo
I => I
J => J
Jack => Jack
Jane => Jane
Jill => Jill
Jim => Jim
Julia => Julia
K => K
Kim => Kim
L => L
Lily => Lily
Lucy => Lucy
M => M
Mark => Mark
Mary => Mary
Matt => Matt
May => May
Miss => Miss
Monday => Monday
Movers => Movers
Mr => Mr
Mrs => Mrs
N => N
Nick => Nick
O => O
OK => OK
P => P
Pat => Pat
Paul => Paul
Peter => Peter
Pre => Pre
Q => Q
R => R
S => S
Sally => Sally
Sam => Sam
Saturday => Saturday
Starters => Starters
Sue => Sue
Sunday => Sunday
T => T
T-shirt => T-shirt
TV/television => TV/television
Thursday => Thursday
Tom => Tom
Tuesday => Tuesday
U => U
UK => UK
US => US
V => V
Vicky => Vicky
W => W
Wednesday => Wednesday
X => X
Y => Y
Z => Z
a => a
ability => ability
about => about
above => above
add => add
address => address
adj => adj
adjective => adjective
adv => adv
adverb => adverb
afraid => afraid
after => after
afternoon => afternoon
again => again
age => age
alien => alien
all => all
along => along
alphabet => alphabet
always => always
an => an
and => and
angry => angry
animal => animal
another => another
answer => answer
any => any
apartment => apartment
app => app
apple => apple
arm => arm
armchair => armchair
around => around
as => a
ask => ask
asleep => asleep
at => at
aunt => aunt
awake => awake
baby => baby
back => back
bad => bad
badly => badly
badminton => badminton
bag => bag
balcony => balcony
ball => ball
balloon => balloon
banana => banana
band => band
baseball => baseball
basement => basement
basketball => basketball
bat => bat
bath => bath
bathroom => bathroom
be => be
beach => beach
bean => bean
bear => bear
beard => beard
beautiful => beautiful
because => because
bed => bed
bedroom => bedroom
bee => bee
before => before
behind => behind
below => below
best => best
better => good
between => between
big => big
bike => bike
bird => bird
birthday => birthday
black => black
blanket => blanket
blond => blond
blue => blue
board => board
boat => boat
body => body
book => book
bookcase => bookcase
bookshop => bookshop
boots => boot
boring => bore
both => both
bottle => bottle
bottom => bottom
bounce => bounce
bowl => bowl
box => box
boy => boy
brave => brave
bread => bread
break => break
breakfast => breakfast
brilliant => brilliant
bring => bring
brother => brother
brown => brown
build => build
building => building
burger => burger
bus => bus
busy => busy
but => but
buy => buy
by => by
bye => bye
cafÃ© => cafÃ©
cage => cage
cake => cake
call => call
called => call
camera => camera
can => can
candy => candy
cap => cap
car => car
careful => careful
carefully => carefully
carrot => carrot
carry => carry
cat => cat
catch => catch
center => center
centre => centre
chair => chair
change => change
cheese => cheese
chicken => chicken
child/children => child/children
chips => chip
chocolate => chocolate
choose => choose
cinema => cinema
circle => circle
circus => circus
city => city
city/town => city/town
clap => clap
class => class
classmate => classmate
classroom => classroom
clean => clean
clever => clever
climb => climb
clock => clock
close => close
closed => close
clothes => clothes
cloud => cloud
cloudy => cloudy
clown => clown
coat => coat
coconut => coconut
coffee => coffee
cold => cold
colour => colour
come => come
comic => comic
complete => complete
computer => computer
conj => conj
conjunction => conjunction
cook => cook
cool => cool
correct => correct
cough => cough
could => could
count => count
country => country
countryside => countryside
cousin => cousin
cow => cow
crayon => crayon
cream => cream
crocodile => crocodile
cross => cross
cry => cry
cup => cup
cupboard => cupboard
curly => curly
dad => dad
dance => dance
dangerous => dangerous
daughter => daughter
day => day
dear => dear
dentist => dentist
desk => desk
det => det
determiner => determiner
difference => difference
different => different
difficult => difficult
dining => din
dinner => dinner
dirty => dirty
dis => dis
discourse => discourse
do => do
doctor => doctor
dog => dog
doll => doll
dolphin => dolphin
done => do
donkey => donkey
donâ€™t => donâ€™t
door => door
double => double
down => down
downstairs => downstairs
draw => draw
drawing => draw
dream => dream
dress => dress
dressed => dress
drink => drink
drive => drive
driver => driver
drop => drop
dry => dry
duck => duck
e => e
e-book => e-book
e.g => e.g
ear => ear
earache => earache
easy => easy
eat => eat
egg => egg
elephant => elephant
elevator => elevator
email => email
end => end
enjoy => enjoy
eraser => eraser
etc => etc
evening => even
every => every
everyone => everyone
everything => everything
example => example
exciting => excite
excl => excl
exclamation => exclamation
excuse => excuse
eye => eye
face => face
fair => fair
fall => fall
family => family
famous => famous
fantastic => fantastic
farm => farm
farmer => farmer
fat => fat
father => father
favorite => favorite
favourite => favourite
feed => fee
field => field
film => film
find => find
fine => fine
first => first
fish => fish
fishing => fish
fix => fix
flat => flat
floor => floor
flower => flower
fly => fly
food => food
foot/feet => foot/feet
football => football
for => for
forest => forest
friend => friend
fries => fry
frightened => frighten
frog => frog
from => from
front => front
fruit => fruit
fun => fun
funfair => funfair
funny => funny
game => game
garden => garden
get => get
giraffe => giraffe
girl => girl
girlâ€™s => girlâ€™s
give => give
glass => glass
glasses => glass
go => go
goal => goal
goat => goat
good => good
goodbye => goodbye
got => get
granddaughter => granddaughter
grandfather => grandfather
grandma => grandma
grandmother => grandmother
grandpa => grandpa
grandparent => grandparent
grandson => grandson
grape => grape
grass => grass
gray => gray
great => great
green => green
grey => grey
ground => ground
grow => grow
grown-up => grown-up
guitar => guitar
hair => hair
hall => hall
hand => hand
handbag => handbag
happy => happy
hat => hat
have => have
he => he
head => head
headache => headache
helicopter => helicopter
hello => hello
helmet => helmet
help => help
her => her
here => here
hers => hers
hi => hi
hide => hide
him => him
hippo => hippo
his => his
hit => hit
hobby => hobby
hockey => hockey
hold => hold
holiday => holiday
home => home
homework => homework
hooray => hooray
hop => hop
horse => horse
hospital => hospital
hot => hot
house => house
how => how
huge => huge
hundred => hundred
hungry => hungry
hurt => hurt
i.e => i.e
ice => ice
idea => idea
ill => ill
in => in
inside => inside
int => int
internet => internet
interrogative => interrogative
into => into
invite => invite
island => island
it => it
its => it
jacket => jacket
jeans => jean
jellyfish => jellyfish
juice => juice
jump => jump
jungle => jungle
key => key
keyboard => keyboard
kick => kick
kid => kid
kitchen => kitchen
kite => kite
kiwi => kiwi
know => know
lake => lake
lamp => lamp
laptop => laptop
last => last
laugh => laugh
leaf/leaves => leaf/leaves
learn => learn
leg => leg
lemon => lemon
lemonade => lemonade
lesson => lesson
letter => letter
letâ€™s => letâ€™s
library => library
lift => lift
like => like
lime => lime
line => line
lion => lion
listen => listen
little => little
live => live
living => living
lizard => lizard
long => long
look => look
lorry => lorry
lose => lose
lot => lot
lots => lot
loud => loud
loudly => loudly
love => love
lunch => lunch
machine => machine
make => make
man/men => man/men
mango => mango
many => many
map => map
marker => marker
market => market
mat => mat
matter => matter
me => me
mean => mean
meat => meat
meatballs => meatball
message => message
milk => milk
milkshake => milkshake
mine => mine
mirror => mirror
mistake => mistake
model => model
monkey => monkey
monster => monster
moon => moon
more => more
morning => morning
most => most
mother => mother
motorbike => motorbike
mountain => mountain
mouse => mouse
mouse/mice => mouse/mice
moustache => moustache
mouth => mouth
move => move
movie => movie
much => much
mum => mum
music => music
must => must
my => my
n => n
name => name
naughty => naughty
near => near
neck => neck
need => need
net => net
never => never
new => new
next => next
nice => nice
night => night
no => no
noise => noise
noodles => noodle
nose => nose
not => not
nothing => nothing
noun => noun
now => now
number => number
nurse => nurse
of => of
off => off
often => often
oh => oh
old => old
on => on
one => one
onion => onion
only => only
open => open
opposite => opposite
or => or
orange => orange
our => our
ours => ours
out => out
outside => outside
oâ€™clock => oâ€™clock
page => page
paint => paint
painting => painting
pair => pair
pancake => pancake
panda => panda
paper => paper
pardon => pardon
parent => parent
park => park
parrot => parrot
part => part
party => party
past => past
pasta => pasta
pea => pea
pear => pear
pen => pen
pencil => pencil
penguin => penguin
person/people => person/people
pet => pet
phone => phone
photo => photo
photo/picture => photo/picture
piano => piano
pick => pick
picnic => picnic
picture => picture
pie => pie
pineapple => pineapple
pink => pink
pirate => pirate
pl => pl
place => place
plane => plane
plant => plant
plate => plate
play => play
player => player
playground => playground
please => please
point => point
polar => polar
pool => pool
pop => pop
poss => po
possessive => possessive
poster => poster
potato => potato
practice => practice
practise => practise
prep => prep
preposition => preposition
present => present
pretty => pretty
pron => pron
pronoun => pronoun
puppy => puppy
purple => purple
put => put
question => question
quick => quick
quickly => quickly
quiet => quiet
quietly => quietly
rabbit => rabbit
racket => racket
radio => radio
rain => rain
rainbow => rainbow
read => read
really => really
red => red
rice => rice
ride => ride
right => right
river => river
road => road
robot => robot
rock => rock
roller => roller
roof => roof
room => room
round => round
rubber => rubber
rug => rug
ruler => ruler
run => run
s => s
sad => sad
safe => safe
sail => sail
salad => salad
sand => sand
sandwich => sandwich
sauce => sauce
sausage => sausage
say => say
scarf => scarf
scary => scary
school => school
score => score
sea => sea
seat => seat
second => second
see => see
send => send
sentence => sentence
shall => shall
shape => shape
shark => shark
she => she
sheep => sheep
shell => shell
ship => ship
shirt => shirt
shoe => shoe
shop => shop
shopping => shop
shopping => shopping
short => short
shorts => short
shoulder => shoulder
shout => shout
show => show
shower => shower
sick => sick
silly => silly
sing => sing
sister => sister
sit => sit
skate => skate
skateboard => skateboard
skateboarding => skateboard
skates => skate
skating => skate
skip => skip
skirt => skirt
sky => sky
sleep => sleep
slow => slow
slowly => slowly
small => small
smile => smile
snail => snail
snake => snake
snow => snow
so => so
soccer => soccer
sock => sock
sofa => sofa
some => some
someone => someone
something => something
sometimes => sometimes
son => son
song => song
sorry => sorry
soup => soup
spell => spell
spider => spider
sport => sport
sports => sport
square => square
stair => stair
stand => stand
star => star
start => start
station => station
stomach => stomach
stomach-ache => stomach-ache
stop => stop
store => store
story => story
straight => straight
street => street
strong => strong
sun => sun
sunny => sunny
supermarket => supermarket
surprised => surprise
sweater => sweater
sweet => sweet
swim => swim
swimming => swim
swimsuit => swimsuit
table => table
tablet => tablet
tail => tail
take => take
talk => talk
tall => tall
tea => tea
teach => teach
teacher => teacher
teddy => teddy
television/TV => television/TV
tell => tell
temperature => temperature
tennis => tennis
terrible => terrible
text => text
than => than
thank => thank
thanks => thanks
that => that
the => the
their => their
theirs => theirs
them => them
then => then
there => there
these => these
they => they
thin => thin
thing => thing
think => think
third => third
thirsty => thirsty
this => this
those => those
throw => throw
tick => tick
ticket => ticket
tiger => tiger
time => time
tired => tire
title => title
to => to
today => today
tomato => tomato
too => too
tooth/teeth => tooth/teeth
toothache => toothache
toothbrush => toothbrush
toothpaste => toothpaste
top => top
towel => towel
town => town
town/city => town/city
toy => toy
tractor => tractor
train => train
travel => travel
treasure => treasure
tree => tree
trip => trip
trousers => trouser
truck => truck
try => try
ugly => ugly
uncle => uncle
under => under
understand => understand
undressed => undressed
up => up
upstairs => upstairs
us => u
v => v
vegetable => vegetable
verb => verb
very => very
video => video
village => village
wait => wait
wake => wake
walk => walk
wall => wall
want => want
wash => wash
watch => watch
water => water
waterfall => waterfall
watermelon => watermelon
wave => wave
we => we
weak => weak
wear => wear
weather => weather
website => website
week => week
weekend => weekend
well => well
wet => wet
whale => whale
what => what
when => when
where => where
which => which
white => white
who => who
whose => whose
why => why
wind => wind
window => window
windy => windy
with => with
woman/women => woman/women
word => word
wordlist => wordlist
work => work
world => world
worry => worry
worse => bad
worst => bad
would => would
wow => wow
write => write
wrong => wrong
year => year
yellow => yellow
yes => yes
yesterday => yesterday
you => you
young => young
your => your
yours => yours
zebra => zebra
zoo => zoo
“ => “