
! => !
& => &
'll => 'll
( => (
) => )
+ => +
, => ,
- => -
-- => --
. => .
/ => /
10 => 10
11 => 11
12 => 12
13 => 13
14 => 14
15 => 15
16 => 16
17 => 17
18 => 18
19 => 19
1st => 1st
20 => 20
2012 => 2012
21 => 21
29 => 29
30 => 30
6 => 6
60 => 60
7 => 7
8 => 8
8. => 8.
9 => 9
: => :
? => ?
@ => @
A1 => A1
Alex => Alex
Alice => Alice
Am => Am
Ann/Anna => Ann/Anna
Anna => Anna
Anne => Anne
Anything => Anything
Are => Are
Aâ€ => Aâ€
B => B
Be => Be
Ben => Ben
Best => Best
Bill => Bill
Br => Br
C => C
CD => CD
Can => Can
Charlie => Charlie
Chicken => Chicken
Clare => Clare
D => D
DVD => DVD
Daisy => Daisy
Dan => Dan
Dear => Dear
Do => Do
Donâ€™t => Donâ€™t
Dr => Dr
E => E
Eng => Eng
England => England
English => English
Eva => Eva
Excuse => Excuse
F => F
Fill => Fill
Firstâ€¦ => Firstâ€¦
France => France
Fred => Fred
French => French
Friday => Friday
G => G
Go => Go
Grace => Grace
Grammatical => Grammatical
H => H
Has => Has
He => He
Heâ€™s => Heâ€™s
How => How
Hugo => Hugo
I => I
ID => ID
IT => IT
Is => Is
It => It
Itâ€™s => Itâ€™s
Iâ€™d => Iâ€™d
Iâ€™ll => Iâ€™ll
Iâ€™m => Iâ€™m
Iâ€™ve => Iâ€™ve
J => J
Jack => Jack
Jane => Jane
Jill => Jill
Jim => Jim
John => John
Julia => Julia
July => July
Just => Just
K => K
KET => KET
Keep => Keep
Kim => Kim
L => L
Lily => Lily
List => List
Liverpool => Liverpool
London => London
Look => Look
Lucy => Lucy
M => M
MP3 => MP3
Manchester => Manchester
Mark => Mark
Mary => Mary
Matt => Matt
May => May
Mind => Mind
Miss => Miss
Monday => Monday
Movers => Movers
Mr => Mr
Mrs => Mrs
Ms => Ms
My => My
N => N
Never => Never
Nick => Nick
O => O
OK => OK
OK/okay => OK/okay
P => P
PC => PC
Page => Page
Pardon => Pardon
Pat => Pat
Paul => Paul
Peter => Peter
Platform => Platform
Please => Please
Pre => Pre
Put => Put
Q => Q
R => R
S => S
Sally => Sally
Sam => Sam
Saturday => Saturday
Shall => Shall
She => She
Show => Show
So => So
Someoneâ€™s => Someoneâ€™s
Sorry => Sorry
Stand => Stand
Starters => Starters
Sue => Sue
Sunday => Sunday
T => T
T-shirt => T-shirt
TV => TV
TV/television => TV/television
Take => Take
That => That
Thatâ€™s => Thatâ€™s
The => The
There => There
They => They
This => This
Thursday => Thursday
Tom => Tom
Tuesday => Tuesday
Turn => Turn
U => U
UCLES => UCLES
UK => UK
US => US
United => United
Use => Use
V => V
Vicky => Vicky
Vocabulary => Vocabulary
W => W
We => We
Wednesday => Wednesday
Welcome => Welcome
What => What
Whatâ€™s => Whatâ€™s
When => When
X => X
Y => Y
Yes => Yes
You => You
Your => Your
Youâ€™re => Youâ€™re
Z => Z
a => a
a.m. => a.m.
a/an => a/an
ability => ability
able => able
about => about
above => above
accident => accident
ache => ache
across => across
act => act
activity => activity
actor => actor
actually => actually
ad => ad
add => add
address => address
adj => adj
adjective => adjective
adult => adult
adv => adv
advanced => advance
adventure => adventure
adverb => adverb
advertisement => advertisement
advice => advice
aeroplane => aeroplane
afraid => afraid
after => after
afternoon => afternoon
afterwards => afterwards
again => again
against => against
age => age
aged => age
ago => ago
agree => agree
air => air
airport => airport
alarm => alarm
album => album
alien => alien
all => all
almost => almost
alone => alone
along => along
alphabet => alphabet
already => already
alright => alright
also => also
always => always
amazing => amazing
ambulance => ambulance
among => among
an => an
and => and
angry => angry
animal => animal
animals => animal
another => another
answer => answer
any => any
anybody => anybody
anymore => anymore
anyone => anyone
anything => anything
anyway => anyway
anywhere => anywhere
apartment => apartment
app => app
apple => apple
appointment => appointment
are => be
area => area
arm => arm
armchair => armchair
around => around
arrive => arrive
arrived => arrive
art => art
article => article
artist => artist
as => a
as => as
ask => ask
asleep => asleep
assistant => assistant
at => at
ate => eat
attractive => attractive
aunt => aunt
autumn => autumn
av => av
available => available
awake => awake
away => away
awful => awful
baby => baby
babyâ€™s => babyâ€™s
back => back
backpack => backpack
bad => bad
badly => badly
badminton => badminton
bag => bag
bake => bake
balcony => balcony
ball => ball
balloon => balloon
banana => banana
band => band
bandage => bandage
bank => bank
bankâ€™s => bankâ€™s
barbecue => barbecue
baseball => baseball
basement => basement
basketball => basketball
bat => bat
bath => bath
bathing => bath
bathing => bathing
bathroom => bathroom
bathtub => bathtub
battery => battery
be => be
beach => beach
bean => bean
bear => bear
beard => beard
beautiful => beautiful
because => because
become => become
bed => bed
bedroom => bedroom
bedrooms => bedroom
bee => bee
before => before
begin => begin
beginner => beginner
beginning => beginning
behind => behind
believe => believe
belong => belong
below => below
belt => belt
beside => beside
best => best
better => good
between => between
bicycle => bicycle
big => big
bigger => big
bike => bike
bill => bill
biology => biology
bird => bird
birth => birth
birthday => birthday
biscuit => biscuit
bit => bit
black => black
black/white => black/white
blackboard => blackboard
blanket => blanket
block => block
blond => blond
blood => blood
blouse => blouse
blue => blue
board => board
boat => boat
body => body
boil => boil
boiled => boil
book => book
bookcase => bookcase
books => book
bookshelf => bookshelf
bookshop => bookshop
bookstore => bookstore
bookâ€™s => bookâ€™s
boot => boot
boots => boot
bored => bore
boring => bore
boring => boring
born => bear
born => born
borrow => borrow
borrowed => borrow
boss => bos
both => both
bother => bother
bottle => bottle
bottom => bottom
bounce => bounce
bowl => bowl
box => box
boy => boy
boyfriend => boyfriend
brain => brain
brave => brave
bread => bread
break => break
breakfast => breakfast
bridge => bridge
bright => bright
brilliant => brilliant
bring => bring
broken => break
broken => broken
brother => brother
brown => brown
brush => brush
build => build
building => building
burger => burger
bus => bus
business => business
businessman => businessman
businesswoman => businesswoman
busy => busy
but => but
butter => butter
buy => buy
by => by
bye => bye
cabinet => cabinet
cafe/cafÃ© => cafe/cafÃ©
cafeteria => cafeteria
cafÃ© => cafÃ©
cage => cage
cake => cake
calendar => calendar
call => call
called => call
cambridgeesol.org => cambridgeesol.org
came => come
camel => camel
camera => camera
camp => camp
camping => camping
campsite => campsite
can => can
candy => candy
cap => cap
capital => capital
car => car
card => card
career => career
careful => careful
carefully => carefully
carpet => carpet
carrot => carrot
carry => carry
cartoon => cartoon
case => case
cash => cash
castle => castle
cat => cat
catch => catch
cathedral => cathedral
ceiling => ceiling
cell => cell
cent => cent
center => center
centimetre/centimeter => centimetre/centimeter
centre => centre
centre/center => centre/center
century => century
cereal => cereal
certainly => certainly
chain => chain
chair => chair
change => change
changed => change
channel => channel
chat => chat
chatroom => chatroom
cheap => cheap
check => check
cheese => cheese
chef => chef
chemist => chemist
chemistry => chemistry
cheque => cheque
chess => chess
chicken => chicken
child => child
child/children => child/children
chilli => chilli
chips => chip
chocolate => chocolate
choose => choose
cinema => cinema
circle => circle
circus => circus
city => city
city/town => city/town
clap => clap
class => class
classical => classical
classmate => classmate
classroom => classroom
clean => clean
cleaner => cleaner
clear => clear
clearly => clearly
clever => clever
click => click
climb => climb
climbing => climbing
clock => clock
close => close
closed => close
clothes => clothes
cloud => cloud
cloudy => cloudy
clown => clown
club => club
cm => cm
coach => coach
coat => coat
coconut => coconut
coffee => coffee
cola => cola
cold => cold
colleague => colleague
collect => collect
college => college
colour => colour
com => com
comb => comb
come => come
comfortable => comfortable
comic => comic
company => company
competition => competition
complete => complete
computer => computer
concert => concert
congratulations => congratulation
conj => conj
conjunction => conjunction
contact => contact
conversation => conversation
cook => cook
cooker => cooker
cookie => cookie
cooking => cooking
cool => cool
copy => copy
corner => corner
correct => correct
cost => cost
costume => costume
cough => cough
could => could
count => count
country => country
countryside => countryside
course => course
cousin => cousin
cover => cover
cow => cow
crayon => crayon
crazy => crazy
cream => cream
credit => credit
cricket => cricket
crocodile => crocodile
cross => cross
crossing => crossing
crowd => crowd
crowded => crowd
cry => cry
crying => cry
cup => cup
cupboard => cupboard
curly => curly
curry => curry
curtain => curtain
customer => customer
cut => cut
cycle => cycle
cycling => cycling
d => d
dad => dad
daily => daily
dance => dance
dancer => dancer
dancing => dancing
danger => danger
dangerous => dangerous
dark => dark
date => date
daughter => daughter
david => david
day => day
dead => dead
dear => dear
decide => decide
deep => deep
degree => degree
degrees => degree
delay => delay
delayed => delay
dentist => dentist
department => department
describe => describe
desert => desert
desk => desk
dessert => dessert
det => det
detail => detail
determiner => determiner
diary => diary
dictionary => dictionary
didnâ€™t => didnâ€™t
die => die
difference => difference
different => different
difficult => difficult
digital => digital
dining => din
dining => dining
dinner => dinner
dinosaur => dinosaur
diploma => diploma
dirty => dirty
dis => dis
disco => disco
discount => discount
discourse => discourse
discuss => discus
dish => dish
do => do
doctor => doctor
document => document
doesnâ€™t => doesnâ€™t
dog => dog
doll => doll
dollar => dollar
dolphin => dolphin
done => do
donkey => donkey
donâ€™t => donâ€™t
door => door
dot => dot
double => double
down => down
download => download
downloaded => download
downstairs => downstairs
draw => draw
drawer => drawer
drawing => draw
drawing => drawing
dream => dream
dress => dress
dressed => dress
drink => drink
drive => drive
driver => driver
driving => drive
driving => driving
drop => drop
drugstore => drugstore
drum => drum
dry => dry
duck => duck
during => during
e => e
e-book => e-book
e.g => e.g
each => each
ear => ear
earache => earache
early => early
earn => earn
earring => earring
easily => easily
east => east
easy => easy
eat => eat
egg => egg
electric => electric
electricity => electricity
elephant => elephant
elevator => elevator
else => else
email => email
empty => empty
end => end
engine => engine
engineer => engineer
enjoy => enjoy
enough => enough
enter => enter
entrance => entrance
envelope => envelope
eraser => eraser
especially => especially
etc => etc
euro => euro
even => even
evening => even
evening => evening
ever => ever
every => every
everybody => everybody
everyone => everyone
everything => everything
everywhere => everywhere
exactly => exactly
examination/exam => examination/exam
example => example
excellent => excellent
except => except
excited => excite
exciting => excite
exciting => exciting
excl => excl
exclam => exclam
exclamation => exclamation
excuse => excuse
exercise => exercise
exhibition => exhibition
exit => exit
expensive => expensive
explain => explain
explore => explore
explorer => explorer
explorers => explorer
extra => extra
eye => eye
face => face
fact => fact
factory => factory
fail => fail
fair => fair
fall => fall
family => family
famous => famous
fan => fan
fantastic => fantastic
far => far
farm => farm
farmer => farmer
fashion => fashion
fast => fast
fat => fat
father => father
favorite => favorite
favourite => favourite
feed => fee
feel => feel
fell => fell
felt => felt
festival => festival
few => few
field => field
file => file
fill => fill
film => film
final => final
finally => finally
find => find
fine => fine
finger => finger
finish => finish
fire => fire
first => first
first-class => first-class
fish => fish
fishing => fish
fishing => fishing
fit => fit
fix => fix
flat => flat
flight => flight
floor => floor
flower => flower
fly => fly
fog => fog
foggy => foggy
follow => follow
food => food
foot => foot
foot/feet => foot/feet
football => football
footballer => footballer
for => for
foreign => foreign
forest => forest
forget => forget
forgot => forget
fork => fork
form => form
found => find
free => free
fresh => fresh
fridge => fridge
fried => fry
friend => friend
friendly => friendly
fries => fry
frightened => frighten
frog => frog
from => from
front => front
fruit => fruit
full => full
fun => fun
funfair => funfair
funny => funny
furniture => furniture
further => far
future => future
game => game
garage => garage
garden => garden
garlic => garlic
gas => gas
gate => gate
geography => geography
get => get
gift => gift
giraffe => giraffe
girl => girl
girlfriend => girlfriend
girlâ€™s => girlâ€™s
give => give
glad => glad
glass => glass
glasses => glass
glove => glove
go => go
goal => goal
goat => goat
going => go
gold => gold
golden => golden
golf => golf
gone => go
good => good
good-looking => good-looking
goodbye => goodbye
got => get
grade => grade
gram => gram
grand => grand
grandchild => grandchild
granddaughter => granddaughter
grandfather => grandfather
grandma => grandma
grandmother => grandmother
grandpa => grandpa
grandparent => grandparent
grandson => grandson
granny => granny
grape => grape
graph => graph
grass => grass
gray => gray
great => great
green => green
grey => grey
grilled => grill
grocery => grocery
ground => ground
group => group
grow => grow
grown-up => grown-up
guess => guess
guest => guest
guest-house => guest-house
guide => guide
guidebook => guidebook
guitar => guitar
guy => guy
gym => gym
hair => hair
half => half
half-price => half-price
hall => hall
hand => hand
handbag => handbag
happen => happen
happy => happy
hard => hard
has => have
hat => hat
hate => hate
have => have
he => he
head => head
headache => headache
headteacher => headteacher
health => health
healthy => healthy
hear => hear
heart => heart
heating => heating
heavy => heavy
helicopter => helicopter
hello => hello
helmet => helmet
help => help
her => her
here => here
hers => hers
herself => herself
hey => hey
hi => hi
hide => hide
high => high
hill => hill
him => him
himself => himself
hip => hip
hippo => hippo
his => his
history => history
hit => hit
hobby => hobby
hockey => hockey
hold => hold
holiday => holiday
home => home
homework => homework
honey => honey
hooray => hooray
hop => hop
hope => hope
horrible => horrible
horse => horse
hospital => hospital
hot => hot
hotel => hotel
hour => hour
hours => hour
house => house
housewife => housewife
how => how
however => however
huge => huge
hundred => hundred
hungry => hungry
hurry => hurry
hurt => hurt
hurts => hurt
husband => husband
i.e => i.e
ice => ice
idea => idea
identification => identification
if => if
ifâ€¦ => ifâ€¦
ill => ill
ill. => ill.
immediately => immediately
important => important
improve => improve
in => in
include => include
including => include
indoor => indoor
indoors => indoors
information => information
insect => insect
inside => inside
instead => instead
instructions => instruction
instrument => instrument
int => int
interested => interested
interesting => interesting
international => international
internet => internet
interrogative => interrogative
into => into
invitation => invitation
invite => invite
is => be
island => island
isnâ€™t => isnâ€™t
it => it
its => it
itself => itself
itâ€™s => itâ€™s
jacket => jacket
jam => jam
jazz => jazz
jeans => jean
jellyfish => jellyfish
jewellery => jewellery
jewelry => jewelry
job => job
join => join
journalist => journalist
journey => journey
juice => juice
jump => jump
jumper => jumper
jungle => jungle
just => just
keep => keep
key => key
keyboard => keyboard
kg => kg
kick => kick
kid => kid
kilogram => kilogram
kilogramme => kilogramme
kilometer => kilometer
kilometre => kilometre
kilometres => kilometres
kind => kind
king => king
kiss => kiss
kit => kit
kitchen => kitchen
kite => kite
kiwi => kiwi
km => km
knife => knife
know => know
known => know
lake => lake
lamp => lamp
language => language
laptop => laptop
large => large
last => last
late => late
later => later
latest => late
laugh => laugh
lazy => lazy
leaf/leaves => leaf/leaves
learn => learn
least => least
leather => leather
leave => leave
leaves => leaf
leaves => leave
left => leave
left => left
left-hand => left-hand
leg => leg
lemon => lemon
lemonade => lemonade
lend => lend
less => less
lesson => lesson
let => let
letter => letter
letâ€™s => letâ€™s
level => level
library => library
licence => licence
lie => lie
life => life
lift => lift
light => light
like => like
lime => lime
line => line
lion => lion
list => list
listen => listen
liter => liter
litre => litre
little => little
live => live
living => living
lizard => lizard
long => long
look => look
lorry => lorry
lose => lose
lost => lose
lot => lot
lots => lot
loud => loud
loudly => loudly
love => love
lovely => lovely
low => low
luck => luck
lucky => lucky
luggage => luggage
lunch => lunch
lunchtime => lunchtime
machine => machine
mad => mad
magazine => magazine
mail => mail
main => main
make => make
make-up => make-up
man => man
man/men => man/men
manager => manager
mango => mango
many => many
map => map
mark => mark
marker => marker
market => market
married => marry
mat => mat
match => match
math => math
maths/mathematics => maths/mathematics
matter => matter
may => may
maybe => maybe
me => me
meal => meal
meals => meal
mean => mean
meat => meat
meatballs => meatball
mechanic => mechanic
medicine => medicine
meet => meet
meeting => meeting
melon => melon
member => member
memory => memory
menu => menu
message => message
meter => meter
metre => metre
midday => midday
middle => middle
midnight => midnight
might => might
mile => mile
milk => milk
milkshake => milkshake
million => million
mind => mind
mine => mine
mineral => mineral
minus => minus
minute => minute
mirror => mirror
miss => miss
missing => miss
mistake => mistake
mix => mix
mobile => mobile
model => model
modern => modern
moment => moment
money => money
monkey => monkey
monster => monster
month => month
monthly => monthly
moon => moon
more => more
morning => morning
most => most
mother => mother
motorbike => motorbike
motorway => motorway
mountain => mountain
mouse => mouse
mouse/mice => mouse/mice
moustache => moustache
mouth => mouth
move => move
movie => movie
much => much
mug => mug
mum => mum
museum => museum
mushroom => mushroom
music => music
musical => musical
musician => musician
must => must
mv => mv
my => my
myself => myself
n => n
name => name
national => national
nationality => nationality
nature => nature
naughty => naughty
near => near
nearly => nearly
neck => neck
necklace => necklace
need => need
neighbour => neighbour
net => net
never => never
new => new
news => news
newspaper => newspaper
next => next
nice => nice
night => night
no => no
nobody => nobody
noise => noise
noisy => noisy
noodles => noodle
noon => noon
normal => normal
north => north
nose => nose
not => not
note => note
notebook => notebook
nothing => nothing
notice => notice
noun => noun
now => now
number => number
nurse => nurse
o'clock => o'clock
occupation => occupation
of => of
off => off
offer => offer
office => office
officer => officer
often => often
oh => oh
oil => oil
old => old
omelette => omelette
on => on
once => once
one => one
one-way => one-way
onion => onion
online => online
only => only
open => open
opera => opera
opposite => opposite
or => or
orange => orange
order => order
other => other
our => our
ours => ours
ourselves => ourselves
out => out
outdoors => outdoors
outside => outside
over => over
own => own
oâ€™clock => oâ€™clock
p.m. => p.m.
pack => pack
page => page
pain => pain
paint => paint
painter => painter
painting => painting
pair => pair
pale => pale
pancake => pancake
panda => panda
paper => paper
pardon => pardon
parent => parent
park => park
parking => parking
parrot => parrot
part => part
partner => partner
party => party
pass => pas
pass => pass
passenger => passenger
passport => passport
past => past
pasta => pasta
path => path
pay => pay
pea => pea
pear => pear
pen => pen
pence => penny
pencil => pencil
penfriend => penfriend
penguin => penguin
penny => penny
people => people
pepper => pepper
per => per
perfect => perfect
perfume => perfume
perhaps => perhaps
person => person
person/people => person/people
personal => personal
pet => pet
petrol => petrol
pharmacy => pharmacy
phone => phone
photo => photo
photo/picture => photo/picture
photographer => photographer
photography => photography
photos => photo
phr => phr
physics => physic
piano => piano
pick => pick
picnic => picnic
picture => picture
pie => pie
piece => piece
pillow => pillow
pilot => pilot
pineapple => pineapple
pink => pink
pirate => pirate
pity => pity
pizza => pizza
pl => pl
place => place
plan => plan
plane => plane
plant => plant
plastic => plastic
plate => plate
platform => platform
play => play
player => player
playground => playground
pleasant => pleasant
please => please
pleased => please
pleased => pleased
plus => plus
pocket => pocket
point => point
polar => polar
police => police
polite => polite
pool => pool
poor => poor
pop => pop
popular => popular
poss => po
possessive => possessive
possible => possible
possibly => possibly
post => post
postcard => postcard
poster => poster
potato => potato
pound => pound
practice => practice
practise => practise
prefer => prefer
prep => prep
prepare => prepare
preposition => preposition
present => present
pretty => pretty
price => price
print => print
printer => printer
prize => prize
probably => probably
problem => problem
program => program
programme => programme
project => project
pron => pron
pronoun => pronoun
pull => pull
pupil => pupil
puppy => puppy
purple => purple
purse => purse
push => push
put => put
puzzle => puzzle
quarter => quarter
queen => queen
question => question
quick => quick
quickest => quick
quickly => quickly
quiet => quiet
quietly => quietly
quite => quite
quiz => quiz
rabbit => rabbit
race => race
raced => race
racket => racket
radio => radio
railway => railway
rain => rain
rainbow => rainbow
raincoat => raincoat
rap => rap
read => read
reading => reading
ready => ready
real => real
really => really
reason => reason
receipt => receipt
receive => receive
receptionist => receptionist
record => record
red => red
refrigerator => refrigerator
remember => remember
rent => rent
repair => repair
repeat => repeat
rest => rest
restaurant => restaurant
restâ€™ => restâ€™
return => return
returned => return
rice => rice
rich => rich
ride => ride
right => right
right/alright => right/alright
ring => ring
river => river
road => road
roast => roast
robot => robot
rock => rock
roller => roller
roof => roof
room => room
round => round
roundabout => roundabout
rubber => rubber
rug => rug
rugby => rugby
ruler => ruler
run => run
runner => runner
running => running
s => s
sad => sad
safe => safe
said => say
sail => sail
sailing => sailing
salad => salad
sale => sale
salt => salt
same => same
sand => sand
sandwich => sandwich
sauce => sauce
sausage => sausage
save => save
say => say
scarf => scarf
scary => scary
school => school
schoolchild => schoolchild
science => science
scissors => scissors
scooter => scooter
score => score
screen => screen
sea => sea
seat => seat
second => second
secretary => secretary
see => see
seen => see
sell => sell
send => send
sentence => sentence
serve => serve
set => set
several => several
shall => shall
shame => shame
shampoo => shampoo
shape => shape
share => share
shark => shark
she => she
sheep => sheep
sheet => sheet
shelf => shelf
shell => shell
ship => ship
shirt => shirt
shoe => shoe
shoes => shoe
shop => shop
shopping => shop
shopping => shopping
short => short
shorts => short
should => should
shoulder => shoulder
shout => shout
show => show
shower => shower
shut => shut
sick => sick
side => side
sightseeing => sightseeing
sign => sign
silly => silly
silver => silver
simple => simple
since => since
sing => sing
singer => singer
singing => singing
single => single
sink => sink
sister => sister
sit => sit
site => site
sitting => sit
size => size
skate => skate
skateboard => skateboard
skateboarding => skateboard
skateboarding => skateboarding
skates => skate
skating => skate
skating => skating
ski => ski
skiing => ski
skiing => skiing
skip => skip
skirt => skirt
sky => sky
sleep => sleep
slice => slice
slim => slim
slow => slow
slowly => slowly
small => small
smile => smile
smoke => smoke
smoking => smoking
snack => snack
snail => snail
snake => snake
snow => snow
snowboard => snowboard
snowboarding => snowboarding
so => so
soap => soap
soccer => soccer
sock => sock
sofa => sofa
soft => soft
software => software
some => some
somebody => somebody
someone => someone
something => something
sometimes => sometimes
somewhere => somewhere
son => son
song => song
songs => song
soon => soon
sorry => sorry
sort => sort
sound => sound
sounds => sound
soup => soup
south => south
space => space
spare => spare
speak => speak
speaker => speaker
special => special
spell => spell
spelling => spelling
spend => spend
spider => spider
spoon => spoon
sport => sport
sports => sport
spring => spring
square => square
stadium => stadium
staff => staff
stage => stage
stair => stair
stairs => stair
stamp => stamp
stand => stand
standing => stand
star => star
start => start
station => station
stay => stay
steak => steak
steal => steal
still => still
stolen => steal
stomach => stomach
stomach-ache => stomach-ache
stop => stop
store => store
storm => storm
story => story
straight => straight
strange => strange
street => street
strong => strong
student => student
studies => study
study => study
subject => subject
such => such
suddenly => suddenly
sugar => sugar
suit => suit
suitcase => suitcase
summer => summer
sun => sun
sunglasses => sunglasses
sunny => sunny
supermarket => supermarket
supper => supper
suppose => suppose
sure => sure
surf => surf
surfboard => surfboard
surfing => surfing
surname => surname
surprise => surprise
surprised => surprise
swam => swim
sweater => sweater
sweet => sweet
swim => swim
swimming => swim
swimming => swimming
swimsuit => swimsuit
table => table
tablet => tablet
tail => tail
take => take
takes => take
talk => talk
tall => tall
taxi => taxi
tea => tea
teach => teach
teacher => teacher
teacherâ€™s => teacherâ€™s
team => team
teddy => teddy
teenager => teenager
telephone => telephone
television => television
television/TV => television/TV
tell => tell
temperature => temperature
temperatureâ€™s => temperatureâ€™s
tennis => tennis
tent => tent
term => term
terrible => terrible
test => test
text => text
textbook => textbook
than => than
thank => thank
thanks => thanks
that => that
the => the
theater => theater
theatre => theatre
their => their
theirs => theirs
them => them
themselves => themselves
then => then
thenâ€¦ => thenâ€¦
there => there
these => these
they => they
thin => thin
thing => thing
think => think
third => third
thirsty => thirsty
this => this
those => those
thought => think
three => three
through => through
throw => throw
thunderstorm => thunderstorm
tick => tick
ticket => ticket
tidy => tidy
tie => tie
tiger => tiger
tights => tights
till => till
time => time
timetable => timetable
tire => tire
tired => tire
title => title
to => to
toast => toast
today => today
toe => toe
together => together
toilet => toilet
tomato => tomato
tomorrow => tomorrow
tonight => tonight
too => too
took => take
tooth => tooth
tooth/teeth => tooth/teeth
toothache => toothache
toothbrush => toothbrush
toothpaste => toothpaste
top => top
total => total
tour => tour
tourist => tourist
towel => towel
town => town
town/city => town/city
toy => toy
tractor => tractor
traffic => traffic
train => train
trainer => trainer
trainers => trainer
tram => tram
travel => travel
treasure => treasure
tree => tree
trip => trip
trouble => trouble
trousers => trouser
truck => truck
true => true
try => try
turn => turn
twice => twice
two => two
type => type
tyre => tyre
ugly => ugly
umbrella => umbrella
uncle => uncle
under => under
underground => underground
understand => understand
undressed => undressed
unfortunately => unfortunately
unhappy => unhappy
uniform => uniform
university => university
until => until
unusual => unusual
up => up
upset => upset
upstairs => upstairs
us => u
use => use
useful => useful
usual => usual
usually => usually
v => v
v/versus => v/versus
variety => variety
various => various
vegetable => vegetable
verb => verb
very => very
video => video
view => view
village => village
violin => violin
visit => visit
visitor => visitor
vocabulary => vocabulary
volleyball => volleyball
wait => wait
waiter => waiter
waiting => wait
waitress => waitress
wake => wake
walk => walk
walked => walk
walking => walking
wall => wall
wallet => wallet
want => want
wanted => want
warm => warm
was => be
wash => wash
washing => wash
washing-up => washing-up
watch => watch
watched => watch
water => water
waterfall => waterfall
watermelon => watermelon
wave => wave
way => way
we => we
weak => weak
wear => wear
wearing => wear
weather => weather
web => web
website => website
week => week
weekday => weekday
weekend => weekend
weekly => weekly
welcome => welcome
well => well
west => west
wet => wet
whale => whale
what => what
wheel => wheel
when => when
where => where
which => which
while => while
white => white
who => who
whole => whole
whose => whose
why => why
wide => wide
wife => wife
wild => wild
will => will
win => win
wind => wind
window => window
windsurfing => windsurfing
windy => windy
winner => winner
winter => winter
wish => wish
wishes => wish
with => with
without => without
woman => woman
woman/women => woman/women
wonderful => wonderful
wood => wood
wooden => wooden
wool => wool
word => word
wordlist => wordlist
work => work
worker => worker
world => world
worried => worry
worry => worry
worse => bad
worse => worse
worst => bad
would => would
wow => wow
write => write
writer => writer
writing => write
writing => writing
wrong => wrong
yeah => yeah
year => year
yellow => yellow
yes => yes
yesterday => yesterday
yet => yet
yoghurt => yoghurt
you => you
young => young
your => your
yours => yours
yourself => yourself
youâ€™re => youâ€™re
zebra => zebra
zero => zero
zoo => zoo
Â£ => Â£
Â£3 => Â£3
Â© => Â©
â€ => â€
â€¢ => â€¢
â€˜Try => â€˜Try
ï‚· => ï‚·
“ => “