
! => !
& => &
' => '
'Do => 'Do
'Sorry => 'Sorry
'Why => 'Why
'd => 'd
'll => 'll
'm => 'm
're => 're
's => 's
've => 've
( => (
) => )
+ => +
, => ,
- => -
-- => --
. => .
... => ...
/ => /
1 => 1
10 => 10
11 => 11
12 => 12
13 => 13
14 => 14
15 => 15
16 => 16
17 => 17
18 => 18
19 => 19
19th => 19th
1st => 1st
2 => 2
20 => 20
2012 => 2012
21 => 21
22 => 22
23 => 23
24 => 24
25 => 25
26 => 26
27 => 27
28 => 28
29 => 29
3-0 => 3-0
30 => 30
31 => 31
32 => 32
33 => 33
34 => 34
35 => 35
36 => 36
37 => 37
40 => 40
5 => 5
500 => 500
51 => 51
6 => 6
6. => 6.
60 => 60
7 => 7
7. => 7.
7.00. => 7.00.
78. => 78.
8 => 8
8. => 8.
9 => 9
90 => 90
: => :
=Am => =Am
? => ?
@ => @
A => A
A1 => A1
AIDS => AIDS
Alex => Alex
Alice => Alice
Am => Am
Ann/Anna => Ann/Anna
Anna => Anna
Anne => Anne
Anything => Anything
Are => Are
Australia => Australia
Aâ€ => Aâ€
B => B
Barbara => Barbara
Be => Be
Ben => Ben
Best => Best
Bill => Bill
Br => Br
C => C
C1 => C1
CD => CD
CD-Rom => CD-Rom
CV => CV
Cambridge => Cambridge
CambridgeEnglish.org => CambridgeEnglish.org
Can => Can
Charlie => Charlie
Chicken => Chicken
Children => Children
Clare => Clare
Click => Click
Come => Come
Control => Control
Could => Could
Cross => Cross
Curriculum => Curriculum
D => D
DVD => DVD
Daisy => Daisy
Dan => Dan
David => David
Dear => Dear
Did => Did
Do => Do
Dogs => Dogs
Donâ€™t => Donâ€™t
Dr => Dr
E => E
Eng => Eng
England => England
English => English
Eva => Eva
Everybody => Everybody
Everything => Everything
Excuse => Excuse
F => F
Fill => Fill
Firstâ€¦ => Firstâ€¦
Four => Four
France => France
Fred => Fred
French => French
Friday => Friday
G => G
Get => Get
Give => Give
Go => Go
Grace => Grace
Grammatical => Grammatical
H => H
Halloween => Halloween
Hand => Hand
Harry => Harry
Has => Has
Have => Have
He => He
Her => Her
Heâ€™s => Heâ€™s
His => His
Hopefully => Hopefully
How => How
Hugo => Hugo
I => I
I'llcome => I'llcome
ID => ID
IT => IT
Ialways => Ialways
Ilove => Ilove
In => In
Information => Information
Ionce => Ionce
Is => Is
It => It
Italy => Italy
Itâ€™s => Itâ€™s
Iwish => Iwish
Iwonder => Iwonder
Iâ€™d => Iâ€™d
Iâ€™ll => Iâ€™ll
Iâ€™m => Iâ€™m
Iâ€™ve => Iâ€™ve
J => J
J.B.H => J.B.H
Jack => Jack
Jane => Jane
Jill => Jill
Jim => Jim
John => John
Julia => Julia
July => July
Just => Just
K => K
KET => KET
Keep => Keep
Kim => Kim
L => L
Let => Let
Lift => Lift
Lily => Lily
List => List
Liverpool => Liverpool
London => London
Look => Look
Lucy => Lucy
M => M
MP3 => MP3
Madam => Madam
Manchester => Manchester
Mark => Mark
Mary => Mary
Matt => Matt
May => May
Mind => Mind
Miss => Miss
Missing => Missing
Mistake => Mistake
Monday => Monday
Movers => Movers
Mr => Mr
Mrs => Mrs
Ms => Ms
My => My
N => N
Never => Never
New => New
Nick => Nick
O => O
O.K./okay => O.K./okay
OJ => OJ
OK => OK
OK/okay => OK/okay
Oh => Oh
P => P
PC => PC
Page => Page
Pardon => Pardon
Pat => Pat
Paul => Paul
Peter => Peter
Platform => Platform
Please => Please
Pre => Pre
Preliminary => Preliminary
Prices => Prices
Put => Put
Q => Q
R => R
S => S
Sally => Sally
Sam => Sam
Saturday => Saturday
Schools => Schools
Several => Several
Shake => Shake
Shall => Shall
She => She
Show => Show
Sir => Sir
Sit => Sit
So => So
Social => Social
Someone => Someone
Someoneâ€™s => Someoneâ€™s
Sorry => Sorry
Sparkling => Sparkling
Speak => Speak
Stand => Stand
Starters => Starters
Studies => Studies
Suddenly => Suddenly
Sue => Sue
Sunday => Sunday
T => T
T-shirt => T-shirt
TV => TV
TV/artists/recording => TV/artists/recording
TV/television => TV/television
Take => Take
Team => Team
Tears => Tears
Technology => Technology
That => That
Thatâ€™s => Thatâ€™s
The => The
There => There
These => These
They => They
This => This
Thomas => Thomas
Thursday => Thursday
Tom => Tom
Tuesday => Tuesday
Turn => Turn
U => U
UCLES => UCLES
UK => UK
US => US
United => United
Use => Use
V => V
Vicky => Vicky
Vitae => Vitae
Vocabulary => Vocabulary
W => W
We => We
Wednesday => Wednesday
Welcome => Welcome
Well => Well
What => What
Whatâ€™s => Whatâ€™s
When => When
Where => Where
Who => Who
Will => Will
Wish => Wish
Would => Would
X => X
Y => Y
Yes => Yes
York => York
You => You
Your => Your
Yours => Yours
Youâ€™re => Youâ€™re
Z => Z
a => a
a.m => a.m
a.m. => a.m.
a/an => a/an
ability => ability
able => able
abolish => abolish
abortion => abortion
about => about
about/for => about/for
above => above
abroad => abroad
absence => absence
absent => absent
absolutely => absolutely
absorb => absorb
abstract => abstract
absurd => absurd
abundance => abundance
abuse => abuse
academy => academy
accelerate => accelerate
accent => accent
accept => accept
acceptance => acceptance
access => access
accessible => accessible
accident => accident
accidentally => accidentally
accommodate => accommodate
accommodation => accommodation
accompany => accompany
accomplish => accomplish
accomplishment => accomplishment
accordance => accordance
according => accord
accordingly => accordingly
account => account
accountability => accountability
accountable => accountable
accountant => accountant
accumulate => accumulate
accumulation => accumulation
accuracy => accuracy
accurate => accurate
accurately => accurately
accusation => accusation
accused => accuse
ache => ache
achieve => achieve
acid => acid
acquisition => acquisition
acre => acre
across => across
act => act
action => action
activate => activate
activation => activation
active => active
activist => activist
activity => activity
actor => actor
actress => actress
actually => actually
acute => acute
ad => ad
adaptation => adaptation
add => add
addiction => addiction
addition => addition
additionally => additionally
address => address
adequate => adequate
adequately => adequately
adhere => adhere
adj => adj
adj. => adj.
adj./adv => adj./adv
adjacent => adjacent
adjective => adjective
adjust => adjust
adjustment => adjustment
administer => administer
administrative => administrative
administrator => administrator
admire => admire
admission => admission
admit => admit
adolescent => adolescent
adoption => adoption
adult => adult
adv => adv
adv. => adv.
advance => advance
advanced => advance
advantage => advantage
adventure => adventure
adverb => adverb
adverse => adverse
advert => advert
advertise => advertise
advertisement => advertisement
advice => advice
advise => advise
advocate => advocate
aeroplane => aeroplane
aesthetic => aesthetic
affection => affection
afford => afford
affordable => affordable
afraid => afraid
after => after
aftermath => aftermath
afternoon => afternoon
afterwards => afterwards
again => again
against => against
age => age
aged => age
agency => agency
agent => agent
aggression => aggression
ago => ago
agree => agree
agricultural => agricultural
agriculture => agriculture
ahead => ahead
aide => aide
aim => aim
air => air
airline => airline
airport => airport
alarm => alarm
albeit => albeit
album => album
alert => alert
alien => alien
align => align
alignment => alignment
alike => alike
alive => alive
all => all
allegation => allegation
allege => allege
allegedly => allegedly
alliance => alliance
allocate => allocate
allocation => allocation
allow => allow
allowance => allowance
ally => ally
almost => almost
alone => alone
along => along
alongside => alongside
aloud => aloud
alphabet => alphabet
already => already
alright => alright
also => also
although => although
altogether => altogether
aluminium => aluminium
always => always
amateur => amateur
amazed => amaze
amazing => amazing
ambassador => ambassador
ambition => ambition
ambulance => ambulance
amend => amend
amendment => amendment
amid => amid
among => among
amongst => amongst
amount => amount
amusing => amuse
amusing => amusing
an => an
analogy => analogy
analyst => analyst
ancestor => ancestor
anchor => anchor
ancient => ancient
and => and
angel => angel
angry => angry
animal => animal
animals => animal
animation => animation
ankle => ankle
anniversary => anniversary
announce => announce
announcement => announcement
annoy => annoy
annual => annual
annually => annually
anonymous => anonymous
another => another
answer => answer
answerphone => answerphone
ant => ant
anticipate => anticipate
antique => antique
anxiety => anxiety
anxious => anxious
any => any
anybody => anybody
anymore => anymore
anyone => anyone
anything => anything
anyway => anyway
anywhere => anywhere
apart => apart
apartment => apartment
apologise => apologise
apology => apology
app => app
apparatus => apparatus
appealing => appeal
appear => appear
appearance => appearance
appetite => appetite
applaud => applaud
apple => apple
applicable => applicable
applicant => applicant
application => application
apply => apply
appoint => appoint
appointment => appointment
appreciation => appreciation
approach => approach
appropriately => appropriately
approve => approve
arbitrary => arbitrary
architect => architect
architectural => architectural
architecture => architecture
archive => archive
are => be
area => area
arena => arena
arguably => arguably
argue => argue
argument => argument
arm => arm
armchair => armchair
army => army
around => around
arrange => arrange
arrangement => arrangement
array => array
arrest => arrest
arrival => arrival
arrive => arrive
arrived => arrive
arriving => arrive
arrow => arrow
art => art
article => article
articulate => articulate
artist => artist
artwork => artwork
as => a
as => as
ash => ash
ashamed => ashamed
aside => aside
ask => ask
asked => ask
asleep => asleep
aspiration => aspiration
aspire => aspire
aspirin => aspirin
assassination => assassination
assault => assault
assemble => assemble
assembly => assembly
assert => assert
assertion => assertion
asset => asset
assign => assign
assistance => assistance
assistant => assistant
assumption => assumption
assurance => assurance
assure => assure
astonishing => astonish
asylum => asylum
at => at
ate => eat
athlete => athlete
athletics => athletics
atmosphere => atmosphere
atrocity => atrocity
attach => attach
attachment => attachment
attack => attack
attain => attain
attempt => attempt
attend => attend
attendance => attendance
attention => attention
attitude => attitude
attorney => attorney
attract => attract
attraction => attraction
attractive => attractive
attribute => attribute
auction => auction
audience => audience
audio => audio
audit => audit
aunt => aunt
authentic => authentic
author => author
authorize => authorize
auto => auto
automatic => automatic
automatically => automatically
autonomy => autonomy
autumn => autumn
av => av
availability => availability
available => available
average => average
avoid => avoid
await => await
awake => awake
awareness => awareness
away => away
awful => awful
awkward => awkward
baby => baby
babysit => babysit
babysitter => babysitter
babyâ€™s => babyâ€™s
back => back
backdrop => backdrop
background => background
backing => back
backpack => backpack
backpacker => backpacker
backpacking => backpacking
backup => backup
backwards => backwards
bad => bad
badge => badge
badly => badly
badminton => badminton
bag => bag
baggage => baggage
bail => bail
bake => bake
baker => baker
balanced => balance
balcony => balcony
bald => bald
ball => ball
ballet => ballet
balloon => balloon
ballot => ballot
banana => banana
band => band
bandage => bandage
bank => bank
banking => banking
bankâ€™s => bankâ€™s
banner => banner
bar => bar
barbecue => barbecue
bare => bare
barely => barely
bargain => bargain
barrel => barrel
base => base
baseball => baseball
basement => basement
basic => basic
basin => basin
basket => basket
basketball => basketball
bass1 => bass1
bat => bat
bath => bath
bathing => bath
bathing => bathing
bathroom => bathroom
bathtub => bathtub
battery => battery
battle => battle
battlefield => battlefield
bay => bay
be => be
beach => beach
beam => beam
bean => bean
bear => bear
beard => beard
beast => beast
beat => beat
beautiful => beautiful
beauty => beauty
because => because
become => become
bed => bed
bedroom => bedroom
bedrooms => bedroom
bee => bee
beef => beef
been => be
before => before
began => begin
begin => begin
beginner => beginner
beginning => beginning
behalf => behalf
behave => behave
behaviour => behaviour
behind => behind
being => be
believe => believe
bell => bell
belong => belong
beloved => beloved
below => below
belt => belt
bench => bench
benchmark => benchmark
beneath => beneath
beneficial => beneficial
beneficiary => beneficiary
benefit => benefit
beside => beside
besides => besides
best => best
betray => betray
better => good
better => well
between => between
beyond => beyond
bias => bias
bicycle => bicycle
bid => bid
big => big
bigger => big
bike => bike
bill => bill
bin => bin
bind => bind
biography => biography
biological => biological
biology => biology
bird => bird
birds => bird
birth => birth
birthday => birthday
biscuit => biscuit
bishop => bishop
bit => bit
bite => bite
bitter => bitter
bizarre => bizarre
black => black
black/white => black/white
blackboard => blackboard
blade => blade
blame => blame
blank => blank
blanket => blanket
blast => blast
bleed => bleed
blend => blend
bless => bless
blessing => bless
blind => blind
block => block
blog => blog
blogger => blogger
blond => blond
blood => blood
blouse => blouse
blow => blow
blowing => blow
blue => blue
board => board
boarding => board
boast => boast
boat => boat
body => body
boil => boil
boiled => boil
bold => bold
bomb => bomb
bombing => bomb
bone => bone
bonus => bonus
book => book
book/buy => book/buy
bookcase => bookcase
booking => book
booking => booking
books => book
bookshelf => bookshelf
bookshop => bookshop
bookstore => bookstore
bookâ€™s => bookâ€™s
boom => boom
boost => boost
boot => boot
boots => boot
border => border
bored => bore
boring => bore
boring => boring
born => bear
born => born
borrow => borrow
borrowed => borrow
boss => bos
both => both
bother => bother
bottle => bottle
bottom => bottom
bounce => bounce
bound => bound
boundary => boundary
bow1 => bow1
bowl => bowl
box => box
boy => boy
boyfriend => boyfriend
bracelet => bracelet
brain => brain
brake => brake
branch => branch
brand => brand
brave => brave
breach => breach
bread => bread
break => break
breakdown => breakdown
breakfast => breakfast
breakthrough => breakthrough
breath => breath
breathe => breathe
breed => breed
breeze => breeze
brick => brick
bride => bride
bridge => bridge
brief => brief
briefly => briefly
bright => bright
brilliant => brilliant
bring => bring
broad => broad
broadband => broadband
broadcaster => broadcaster
broadly => broadly
broccoli => broccoli
brochure => brochure
broke => break
broken => break
broken => broken
brother => brother
brought => bring
brown => brown
browser => browser
brush => brush
brutal => brutal
buck => buck
bucket => bucket
buddy => buddy
buffer => buffer
bug => bug
build => build
building => building
bulb => bulb
bulk => bulk
bull => bull
bunch => bunch
burden => burden
bureaucracy => bureaucracy
burger => burger
burial => burial
burn => burn
burning => burning
burst => burst
bury => bury
bus => bus
bus/fire/radio => bus/fire/radio
business => business
businessman => businessman
businesswoman => businesswoman
busy => busy
but => but
butcher => butcher
butter => butter
butterfly => butterfly
button => button
buy => buy
buyer => buyer
by => by
bye => bye
ca => ca
cab => cab
cabbage => cabbage
cabin => cabin
cabinet => cabinet
cable => cable
cafe/cafe => cafe/cafe
cafe/cafÃ© => cafe/cafÃ©
cafeteria => cafeteria
cafÃ© => cafÃ©
cage => cage
cake => cake
calculation => calculation
calculator => calculator
calendar => calendar
calf => calf
call => call
called => call
calm => calm
cambridgeenglish.org => cambridgeenglish.org
cambridgeesol.org => cambridgeesol.org
came => come
camel => camel
camera => camera
camp => camp
camping => camp
camping => camping
campsite => campsite
can => can
canal => canal
cancel => cancel
candidate => candidate
candle => candle
candy => candy
canteen => canteen
canvas => canvas
cap => cap
capability => capability
capital => capital
capitalism => capitalism
capitalist => capitalist
captain => captain
car => car
carbon => carbon
card => card
cardboard => cardboard
care => care
career => career
careful => careful
carefully => carefully
careless => careless
cargo => cargo
carpet => carpet
carriage => carriage
carried => carry
carrot => carrot
carry => carry
cars => car
cartoon => cartoon
carve => carve
case => case
cash => cash
cashpoint => cashpoint
casino => casino
castle => castle
casual => casual
casualty => casualty
cat => cat
catalogue => catalogue
catch => catch
cater => cater
cathedral => cathedral
cattle => cattle
caution => caution
cautious => cautious
cave => cave
cease => cease
ceiling => ceiling
celebrate => celebrate
celebration => celebration
celebrity => celebrity
cell => cell
cemetery => cemetery
cent => cent
center => center
centimeter => centimeter
centimetre => centimetre
centimetre/centimeter => centimetre/centimeter
central => central
centre => centre
centre/center => centre/center
century => century
cereal => cereal
ceremony => ceremony
certain => certain
certainly => certainly
certainty => certainty
certificate => certificate
chain => chain
chair => chair
challenge => challenge
challenging => challenge
challenging => challenging
chamber => chamber
champion => champion
championship => championship
chance => chance
change => change
changed => change
changing => changing
channel => channel
chaos => chaos
chapter => chapter
character => character
characterize => characterize
charge => charge
charges/cost/price => charges/cost/price
charity => charity
charm => charm
charming => charm
charming => charming
charter => charter
chase => chase
chat => chat
chatroom => chatroom
cheap => cheap
cheat => cheat
checkin => checkin
check => check
check-in => check-in
checked => check
checkout => checkout
cheek => cheek
cheeks => cheek
cheer => cheer
cheerful => cheerful
cheers => cheer
cheese => cheese
chef => chef
chemist => chemist
chemistry => chemistry
cheque => cheque
chess => chess
chest => chest
chewing => chew
chicken => chicken
child => child
child/children => child/children
childhood => childhood
children => child
chilli => chilli
chin => chin
chip => chip
chips => chip
chocolate => chocolate
choice => choice
choir => choir
choose => choose
chop => chop
chronic => chronic
chunk => chunk
cigarette => cigarette
cinema => cinema
circle => circle
circuit => circuit
circulate => circulate
circulation => circulation
circus => circus
citizenship => citizenship
city => city
city/town => city/town
civic => civic
civilian => civilian
civilization => civilization
clap => clap
clarify => clarify
clarity => clarity
clash => clash
class => class
classical => classical
classification => classification
classify => classify
classmate => classmate
classroom => classroom
clean => clean
cleaner => cleaner
clear => clear
clearly => clearly
clerk => clerk
clever => clever
click => click
cliff => cliff
climate => climate
climb => climb
climbing => climbing
cling => cling
clinic => clinic
clinical => clinical
clip => clip
clock => clock
close => close
closed => close
closure => closure
clothes => clothes
clothes/a => clothes/a
cloud => cloud
cloudy => cloudy
clown => clown
club => club
cluster => cluster
cm => cm
coach => coach
coalition => coalition
coast => coast
coastal => coastal
coat => coat
cocktail => cocktail
coconut => coconut
cod => cod
coffee => coffee
cognitive => cognitive
coin => coin
coincide => coincide
coincidence => coincidence
cola => cola
cold => cold
cold-water => cold-water
collaborate => collaborate
collaboration => collaboration
collar => collar
colleague => colleague
collect => collect
collection => collection
collective => collective
collector => collector
college => college
collision => collision
colonial => colonial
colony => colony
colour => colour
colourful => colourful
columnist => columnist
com => com
comb => comb
combat => combat
come => come
comedy => comedy
comes => come
comfort => comfort
comfortable => comfortable
comic => comic
comma => comma
commander => commander
commence => commence
commentary => commentary
commentator => commentator
commerce => commerce
commissioner => commissioner
commodity => commodity
common => common
communicate => communicate
communication => communication
communist => communist
compact => compact
companion => companion
company => company
comparable => comparable
comparative => comparative
compare => compare
compassion => compassion
compel => compel
compelling => compel
compensate => compensate
compensation => compensation
compete => compete
competence => competence
competent => competent
competition => competition
competitor => competitor
compile => compile
complain => complain
complaint => complaint
complement => complement
complete => complete
completely => completely
completion => completion
complexity => complexity
compliance => compliance
complicated => complicate
complication => complication
comply => comply
compose => compose
composer => composer
composition => composition
compound => compound
comprehensive => comprehensive
comprise => comprise
compromise => compromise
compulsory => compulsory
compute => compute
computer => computer
conceal => conceal
concede => concede
conceive => conceive
concentrate => concentrate
conception => conception
concert => concert
concession => concession
conclusion => conclusion
concrete => concrete
condemn => condemn
condition => condition
conditioning => conditioning
confer => confer
conference => conference
confess => confess
confession => confession
confident => confident
configuration => configuration
confine => confine
confirm => confirm
confirmation => confirmation
confront => confront
confrontation => confrontation
confused => confuse
confusing => confusing
confusion => confusion
congratulate => congratulate
congratulations => congratulation
congregation => congregation
congressional => congressional
conj => conj
conjunction => conjunction
connect => connect
connection => connection
conquer => conquer
conscience => conscience
consciousness => consciousness
consecutive => consecutive
consensus => consensus
consent => consent
consequently => consequently
conservation => conservation
conserve => conserve
consider => consider
considerable => considerable
considerably => considerably
consist => consist
consistency => consistency
consistently => consistently
consolidate => consolidate
consonant => consonant
conspiracy => conspiracy
constituency => constituency
constitute => constitute
constitution => constitution
constitutional => constitutional
constraint => constraint
consult => consult
consultant => consultant
consultation => consultation
consumption => consumption
contact => contact
contain => contain
contemplate => contemplate
contempt => contempt
contend => contend
contender => contender
content2 => content2
contention => contention
contents => content
contest => contest
continent => continent
continually => continually
continue => continue
contract => contract
contractor => contractor
contradiction => contradiction
contrary => contrary
contributor => contributor
control => control
controversial => controversial
controversy => controversy
convenience => convenience
convenient => convenient
convention => convention
conventional => conventional
conversation => conversation
conversion => conversion
convey => convey
convict => convict
conviction => conviction
convince => convince
convincing => convince
cook => cook
cooker => cooker
cookie => cookie
cooking => cooking
cool => cool
cooperate => cooperate
cooperative => cooperative
coordinate => coordinate
coordination => coordination
coordinator => coordinator
cop => cop
cope => cope
copper => copper
copy => copy
copyright => copyright
corn => corn
corner => corner
corporation => corporation
correct => correct
correction => correction
correctly => correctly
correlate => correlate
correlation => correlation
correspond => correspond
correspondence => correspondence
correspondent => correspondent
corresponding => correspond
corridor => corridor
corrupt => corrupt
corruption => corruption
cost => cost
costly => costly
costume => costume
cosy => cosy
cottage => cottage
cotton => cotton
cough => cough
could => could
councillor => councillor
counselling => counsel
counsellor => counsellor
count => count
counter => counter
counterpart => counterpart
countless => countless
country => country
countryside => countryside
coup => coup
couple => couple
courage => courage
course => course
court => court
courtesy => courtesy
cousin => cousin
cover => cover
coverage => coverage
cow => cow
crack => crack
craft => craft
crash => crash
crawl => crawl
crayon => crayon
crazy => crazy
cream => cream
create => create
creative => creative
creativity => creativity
creator => creator
creature => creature
credibility => credibility
credible => credible
credit => credit
creep => creep
crew => crew
cricket => cricket
crime => crime
criminal => criminal
critically => critically
critique => critique
crocodile => crocodile
crop => crop
cross => cross
crossing => cross
crossing => crossing
crossroads => crossroad
crowd => crowd
crowded => crowd
crown => crown
crude => crude
cruel => cruel
cruise => cruise
crush => crush
cry => cry
crying => cry
crystal => crystal
cucumber => cucumber
cue => cue
cult => cult
cultivate => cultivate
cultural => cultural
culture => culture
cup => cup
cupboard => cupboard
cure => cure
curiosity => curiosity
curious => curious
curiously => curiously
curly => curly
currency => currency
curriculum => curriculum
curry => curry
curtain => curtain
curtains => curtain
cushion => cushion
custody => custody
custom => custom
customer => customer
customs => custom
cut => cut
cute => cute
cutting => cut
cycle => cycle
cycling => cycling
cyclist => cyclist
cynical => cynical
d => d
dad => dad
daily => daily
dairy => dairy
dam => dam
damage => damage
damaged => damage
damaging => damage
dance => dance
dancer => dancer
dancing => dancing
danger => danger
dangerous => dangerous
dare => dare
dark => dark
darkness => darkness
database => database
date => date
daughter => daughter
david => david
dawn => dawn
day => day
dead => dead
deadline => deadline
deadly => deadly
deaf => deaf
deal => deal
dealer => dealer
dear => dear
death => death
debris => debris
debut => debut
decide => decide
decided => decide
decision => decision
decision-making => decision-making
decisive => decisive
deck => deck
declaration => declaration
declare => declare
decorate => decorate
decrease => decrease
dedicated => dedicate
dedication => dedication
deed => deed
deem => deem
deep => deep
default => default
defeat => defeat
defect => defect
defence => defence
defend => defend
defender => defender
defensive => defensive
deficiency => deficiency
deficit => deficit
definitely => definitely
defy => defy
degree => degree
degrees => degree
delay => delay
delayed => delay
delegate => delegate
delegation => delegation
delete => delete
deliberately => deliberately
delicate => delicate
delicious => delicious
delighted => delight
deliver => deliver
delivery => delivery
demand => demand
democracy => democracy
democratic => democratic
demon => demon
demonstration => demonstration
denial => denial
denounce => denounce
dense => dense
density => density
dentist => dentist
depart => depart
department => department
departure => departure
depend => depend
dependence => dependence
dependent => dependent
depends => depend
depict => depict
deploy => deploy
deployment => deployment
deposit => deposit
depressed => depress
depression => depression
deprive => deprive
depth => depth
deputy => deputy
derive => derive
descend => descend
descent => descent
describe => describe
description => description
desert => desert
deserve => deserve
design => design
designate => designate
designer => designer
desirable => desirable
desk => desk
desktop => desktop
desperately => desperately
despite => despite
dessert => dessert
destination => destination
destroy => destroy
destruction => destruction
destructive => destructive
det => det
detail => detail
detain => detain
detection => detection
detective => detective
detention => detention
deteriorate => deteriorate
determination => determination
determiner => determiner
devastate => devastate
develop => develop
development => development
devil => devil
devise => devise
devote => devote
diagnose => diagnose
diagnosis => diagnosis
diagram => diagram
dial => dial
diary => diary
dictate => dictate
dictator => dictator
dictionary => dictionary
did => do
didnâ€™t => didnâ€™t
die => die
diet => diet
differ => differ
difference => difference
different => different
differentiate => differentiate
difficult => difficult
difficulty => difficulty
dig => dig
digital => digital
dignity => dignity
dilemma => dilemma
dimension => dimension
diminish => diminish
dining => din
dining => dining
dinner => dinner
dinosaur => dinosaur
dip => dip
diploma => diploma
diplomat => diplomat
diplomatic => diplomatic
direct => direct
direction => direction
directly => directly
director => director
directory => directory
dirt => dirt
dirty => dirty
dis => dis
disability => disability
disabled => disable
disabled => disabled
disadvantage => disadvantage
disagree => disagree
disagreement => disagreement
disappear => disappear
disappoint => disappoint
disappointed => disappoint
disappointing => disappointing
disappointment => disappointment
disastrous => disastrous
disc => disc
disc/CO => disc/CO
disc/disk => disc/disk
discard => discard
discharge => discharge
disclose => disclose
disclosure => disclosure
disco => disco
discount => discount
discourage => discourage
discourse => discourse
discover => discover
discretion => discretion
discrimination => discrimination
discuss => discus
discussed => discuss
discussion => discussion
disease => disease
disgusting => disgusting
dish => dish
dishwasher => dishwasher
disk => disk
dislike => dislike
dismissal => dismissal
disorder => disorder
displace => displace
display => display
disposal => disposal
dispose => dispose
dispute => dispute
disrupt => disrupt
disruption => disruption
dissolve => dissolve
distance => distance
distant => distant
distinct => distinct
distinction => distinction
distinctive => distinctive
distinguish => distinguish
distort => distort
distract => distract
distress => distress
district => district
disturb => disturb
disturbing => disturb
dive => dive
diver => diver
diverse => diverse
diversity => diversity
divert => divert
divide => divide
divine => divine
diving => diving
divorce => divorce
do => do
doctor => doctor
doctrine => doctrine
document => document
documentary => documentary
documentation => documentation
documents => document
does => do
doesnâ€™t => doesnâ€™t
dog => dog
doing => do
doll => doll
dollar => dollar
dolphin => dolphin
domain => domain
dominance => dominance
dominant => dominant
donation => donation
done => do
donkey => donkey
donor => donor
donâ€™t => donâ€™t
door => door
dose => dose
dot => dot
double => double
doubt => doubt
down => down
download => download
downloaded => download
downstairs => downstairs
downtown => downtown
dozen => dozen
drag => drag
drain => drain
drama => drama
dramatically => dramatically
draw => draw
drawer => drawer
drawers => drawer
drawing => draw
drawing => drawing
dream => dream
dress => dress
dressed => dress
drift => drift
drink => drink
drive => drive
driver => driver
driving => drive
driving => driving
driving/marriage/TV => driving/marriage/TV
drop => drop
drought => drought
drown => drown
drugstore => drugstore
drum => drum
dry => dry
dual => dual
dub => dub
duck => duck
due => due
dull => dull
dumb => dumb
dump => dump
duo => duo
duration => duration
during => during
dust => dust
dustbin => dustbin
dusty => dusty
duty => duty
duty-free => duty-free
duvet => duvet
dynamic => dynamic
e => e
e-book => e-book
e.g => e.g
each => each
eager => eager
ear => ear
earache => earache
early => early
earn => earn
earnings => earnings
earring => earring
earth => earth
ease => ease
easily => easily
east => east
eastern => eastern
easy => easy
easygoing => easygoing
eat => eat
echo => echo
ecological => ecological
economics => economics
economist => economist
edge => edge
editorial => editorial
education => education
educator => educator
effect => effect
effectiveness => effectiveness
efficiency => efficiency
efficient => efficient
efficiently => efficiently
effort => effort
egg => egg
ego => ego
either => either
elaborate => elaborate
elbow => elbow
elder => elder
elderly => elderly
election => election
electoral => electoral
electric => electric
electrical => electrical
electricity => electricity
electronic => electronic
electronics => electronics
elegant => elegant
elementary => elementary
elephant => elephant
elevate => elevate
elevator => elevator
eligible => eligible
eliminate => eliminate
elite => elite
else => else
em => em
email => email
embark => embark
embarrassed => embarrass
embarrassing => embarrassing
embarrassment => embarrassment
embassy => embassy
embed => embed
embody => embody
embrace => embrace
emergence => emergence
emergency => emergency
emission => emission
emotionally => emotionally
empire => empire
empirical => empirical
employ => employ
employee => employee
employer => employer
employment => employment
empower => empower
empty => empty
enact => enact
encompass => encompass
encourage => encourage
encouragement => encouragement
encouraging => encourage
end => end
endeavour => endeavour
ending => end
endless => endless
endorse => endorse
endorsement => endorsement
endure => endure
enemy => enemy
energy => energy
enforce => enforce
enforcement => enforcement
engaged => engage
engagement => engagement
engaging => engage
engine => engine
engineer => engineer
engineering => engineering
enjoy => enjoy
enjoyable => enjoyable
enormous => enormous
enough => enough
enquire => enquire
enquiry => enquiry
enrich => enrich
enrol => enrol
ensue => ensue
enter => enter
enterprise => enterprise
entertain => entertain
entertaining => entertain
entertainment => entertainment
enthusiast => enthusiast
entitle => entitle
entity => entity
entrance => entrance
entrepreneur => entrepreneur
entry => entry
envelope => envelope
environment => environment
environmental => environmental
epidemic => epidemic
equal => equal
equality => equality
equation => equation
equip => equip
equipment => equipment
equivalent => equivalent
era => era
eraser => eraser
erect => erect
erupt => erupt
escalate => escalate
escape => escape
especially => especially
essay => essay
essence => essence
essential => essential
essentially => essentially
establishment => establishment
etc => etc
eternal => eternal
ethic => ethic
ethnic => ethnic
euro => euro
evacuate => evacuate
evaluation => evaluation
even => even
evening => even
evening => evening
event => event
ever => ever
every => every
everybody => everybody
everyone => everyone
everything => everything
everywhere => everywhere
evident => evident
evoke => evoke
evolution => evolution
evolutionary => evolutionary
evolve => evolve
exact => exact
exactly => exactly
exaggerate => exaggerate
examination => examination
examination/exam => examination/exam
examiner => examiner
example => example
exams => exam
exceed => exceed
excellence => excellence
excellent => excellent
except => except
exception => exception
exceptional => exceptional
excess => excess
excessive => excessive
exchange => exchange
excited => excite
excitement => excitement
exciting => excite
exciting => exciting
excl => excl
exclam => exclam
exclamation => exclamation
exclude => exclude
exclusion => exclusion
exclusive => exclusive
exclusively => exclusively
excuse => excuse
execute => execute
execution => execution
exercise => exercise
exert => exert
exhausted => exhaust
exhibit => exhibit
exhibition => exhibition
exile => exile
exist => exist
exit => exit
exotic => exotic
expansion => expansion
expect => expect
expedition => expedition
expenditure => expenditure
expensive => expensive
experience => experience
experienced => experience
experiment => experiment
experimental => experimental
expert => expert
expertise => expertise
expire => expire
explain => explain
explanation => explanation
explicit => explicit
explicitly => explicitly
explode => explode
exploit => exploit
exploitation => exploitation
explore => explore
explorer => explorer
explorers => explorer
explosive => explosive
exposure => exposure
extension => extension
extensive => extensive
extensively => extensively
extra => extra
extract => extract
extraordinary => extraordinary
extreme => extreme
extremely => extremely
extremist => extremist
eye => eye
eyes => eye
fabric => fabric
fabulous => fabulous
face => face
face-to-face => face-to-face
facilitate => facilitate
facilities => facility
fact => fact
faction => faction
factory => factory
faculty => faculty
fade => fade
fail => fail
failed => fail
fair => fair
fairly => fairly
fairness => fairness
fake => fake
fall => fall
false => false
fame => fame
familiar => familiar
family => family
famous => famous
fan => fan
fancy => fancy
fantastic => fantastic
fantasy => fantasy
far => far
fare => fare
farm => farm
farmer => farmer
farming => farming
fashion => fashion
fashionable => fashionable
fast => fast
fasten => fasten
fat => fat
fatal => fatal
fate => fate
father => father
fault => fault
favorite => favorite
favour => favour
favourable => favourable
favourite => favourite
fax => fax
fear => fear
feat => feat
federal => federal
fee => fee
feed => fee
feed => feed
feel => feel
feeling => feeling
fell => fell
felt => felt
female => female
feminist => feminist
ferry => ferry
festival => festival
fetch => fetch
fever => fever
few => few
fibre => fibre
fiction => fiction
field => field
fierce => fierce
fight => fight
figure => figure
file => file
files => file
fill => fill
filled => fill
film => film
film-maker => film-maker
filter => filter
final => final
finally => finally
financial => financial
find => find
fine => fine
finger => finger
finish => finish
finished => finish
fire => fire
firearm => firearm
firefighter => firefighter
firework => firework
firm => firm
firmly => firmly
first => first
first-class => first-class
fish => fish
fishing => fish
fishing => fishing
fit => fit
fitness => fitness
five => five
fix => fix
fixture => fixture
flag => flag
flat => flat
flavour => flavour
flaw => flaw
flawed => flaw
flee => flee
fleet => fleet
flesh => flesh
flexibility => flexibility
flight => flight
float => float
flood => flood
floor => floor
floppy => floppy
flour => flour
flourish => flourish
flow => flow
flower => flower
flowers => flower
flu => flu
fluid => fluid
flute => flute
fly => fly
flying => fly
fog => fog
foggy => foggy
fold => fold
folk => folk
follow => follow
following => following
fond => fond
food => food
fool => fool
foot => foot
foot/feet => foot/feet
footage => footage
football => football
footballer => footballer
for => for
forbid => forbid
forbidden => forbidden
force => force
forecast => forecast
foreign => foreign
foreigner => foreigner
forest => forest
forever => forever
forge => forge
forget => forget
forgive => forgive
forgot => forget
fork => fork
form => form
format => format
formation => formation
former => former
formerly => formerly
formula => formula
formulate => formulate
forth => forth
forthcoming => forthcoming
fortnight => fortnight
fortunate => fortunate
fortunately => fortunately
forum => forum
forward => forward
fossil => fossil
foster => foster
found => find
foundation => foundation
founder => founder
fountain => fountain
fraction => fraction
fragile => fragile
fragment => fragment
frame => frame
framework => framework
franchise => franchise
frankly => frankly
fraud => fraud
free => free
freely => freely
freeze => freeze
freezer => freezer
freezing => freezing
frequent => frequent
fresh => fresh
fridge => fridge
fried => fry
friend => friend
friendly => friendly
friends => friend
friendship => friendship
fries => fry
frighten => frighten
frightened => frighten
frightening => frightening
frog => frog
from => from
front => front
frozen => frozen
fruit => fruit
frustrated => frustrate
frustrating => frustrate
frustration => frustration
fry => fry
frying => fry
fuel => fuel
fulfil => fulfil
full => full
full-time => full-time
fully => fully
fun => fun
functional => functional
fundamentally => fundamentally
fundraising => fundraise
funeral => funeral
funfair => funfair
funny => funny
fur => fur
furious => furious
furniture => furniture
furniture/advice => furniture/advice
further => far
further => further
furthest => furthest
future => future
gain => gain
gallery => gallery
gallon => gallon
gambling => gamble
game => game
gaming => game
gap => gap
garage => garage
garden => garden
garlic => garlic
gas => gas
gate => gate
gathering => gathering
gave => give
gay => gay
gaze => gaze
gear => gear
gender => gender
gene => gene
general => general
generally => generally
generation => generation
generic => generic
generous => generous
genetic => genetic
genius => genius
genocide => genocide
gentle => gentle
genuine => genuine
genuinely => genuinely
geography => geography
gesture => gesture
get => get
getting => get
giant => giant
gift => gift
gig => gig
giraffe => giraffe
girl => girl
girlfriend => girlfriend
girlâ€™s => girlâ€™s
give => give
given => give
glad => glad
glance => glance
glass => glass
glasses => glass
glimpse => glimpse
global => global
globalization => globalization
globe => globe
glorious => glorious
glory => glory
glove => glove
go => go
goal => goal
goalkeeper => goalkeeper
goat => goat
going => go
gold => gold
golden => golden
golf => golf
gone => go
good => good
good-looking => good-looking
good/poor => good/poor
goodbye => goodbye
goodness => goodness
gorgeous => gorgeous
got => get
governance => governance
government => government
governor => governor
grab => grab
grabbed => grab
grace => grace
grade => grade
graduation => graduation
gram => gram
grammar => grammar
grand => grand
grandchild => grandchild
granddaughter => granddaughter
grandfather => grandfather
grandma => grandma
grandmother => grandmother
grandpa => grandpa
grandparent => grandparent
grandson => grandson
granny => granny
grant => grant
grape => grape
graph => graph
graphic => graphic
graphics => graphic
grasp => grasp
grass => grass
grateful => grateful
grave => grave
gravity => gravity
gray => gray
great => great
greatly => greatly
green => green
greenhouse => greenhouse
greet => greet
greeting => greeting
grey => grey
grid => grid
grief => grief
grill => grill
grilled => grill
grin => grin
grind => grind
grip => grip
grocery => grocery
groom => groom
gross => gross
ground => ground
group => group
grow => grow
grown-up => grown-up
guard => guard
guerrilla => guerrilla
guess => guess
guest => guest
guest-house => guest-house
guidance => guidance
guide => guide
guidebook => guidebook
guideline => guideline
guilt => guilt
guilty => guilty
guitar => guitar
guitarist => guitarist
gum => gum
gun => gun
gut => gut
guy => guy
gym => gym
gymnastics => gymnastics
habit => habit
habitat => habitat
had => have
hail => hail
hair => hair
haircut => haircut
hairdresser => hairdresser
hairdryer => hairdryer
half => half
half-price => half-price
halfway => halfway
hall => hall
halt => halt
hand => hand
hand-held => hand-held
handbag => handbag
handful => handful
handkerchief => handkerchief
handle => handle
handling => handle
handsome => handsome
handwriting => handwriting
handy => handy
hang => hang
happen => happen
happened => happen
happily => happily
happiness => happiness
happy => happy
harassment => harassment
harbour => harbour
hard => hard
hardly => hardly
hardware => hardware
harm => harm
harmony => harmony
harsh => harsh
harvest => harvest
has => have
hat => hat
hate => hate
hatred => hatred
haunt => haunt
have => have
hazard => hazard
he => he
head => head
headache => headache
headline => headline
headquarters => headquarters
headteacher => headteacher
heal => heal
health => health
healthcare => healthcare
healthy => healthy
hear => hear
heart => heart
heat => heat
heater => heater
heating => heating
heavy => heavy
heel => heel
heels => heel
height => height
heighten => heighten
held => hold
helicopter => helicopter
hello => hello
helmet => helmet
help => help
helped => help
hence => hence
her => her
herb => herb
here => here
heritage => heritage
hero => hero
heroine => heroine
hers => hers
herself => herself
hey => hey
hi => hi
hidden => hidden
hide => hide
hierarchy => hierarchy
high => high
high-profile => high-profile
highway => highway
hilarious => hilarious
hill => hill
him => him
himself => himself
hint => hint
hip => hip
hippo => hippo
hire => hire
his => his
historian => historian
historic => historic
historical => historical
history => history
hit => hit
hitchhike => hitchhike
hobby => hobby
hockey => hockey
hold => hold
hole => hole
holiday => holiday
home => home
homeland => homeland
homeless => homeless
homepage => homepage
homework => homework
honest => honest
honestly => honestly
honesty => honesty
honey => honey
honeymoon => honeymoon
hook => hook
hooray => hooray
hop => hop
hope => hope
hopeful => hopeful
hopefully => hopefully
hopeless => hopeless
horizon => horizon
horn => horn
horrible => horrible
horror => horror
horse => horse
hospital => hospital
hostage => hostage
hostel => hostel
hostile => hostile
hostility => hostility
hot => hot
hotel => hotel
hour => hour
hours => hour
house => house
housewife => housewife
housework => housework
how => how
however => however
hug => hug
huge => huge
human => human
humanitarian => humanitarian
humanity => humanity
humble => humble
humid => humid
hundred => hundred
hung => hang
hunger => hunger
hungry => hungry
hunt => hunt
hurry => hurry
hurt => hurt
hurts => hurt
husband => husband
hut => hut
hydrogen => hydrogen
hypothesis => hypothesis
i.e => i.e
ice => ice
icon => icon
icy => icy
idea => idea
identical => identical
identification => identification
identity => identity
ideological => ideological
ideology => ideology
idiot => idiot
if => if
ifâ€¦ => ifâ€¦
ignorance => ignorance
ill => ill
ill. => ill.
illness => illness
illusion => illusion
imagery => imagery
imagination => imagination
imagine => imagine
immediately => immediately
immense => immense
immigration => immigration
imminent => imminent
immune => immune
implement => implement
implementation => implementation
implication => implication
importance => importance
important => important
impossible => impossible
imprison => imprison
imprisonment => imprisonment
improve => improve
improvement => improvement
in => in
inability => inability
inadequate => inadequate
inappropriate => inappropriate
incentive => incentive
inch => inch
incidence => incidence
inclined => incline
include => include
including => include
inclusion => inclusion
incorporate => incorporate
incorrect => incorrect
increase => increase
incredible => incredible
incur => incur
indeed => indeed
independence => independence
independent => independent
index => index
indication => indication
indicator => indicator
indictment => indictment
indigenous => indigenous
individual => individual
indoor => indoor
indoors => indoors
induce => induce
indulge => indulge
industry => industry
inequality => inequality
inevitable => inevitable
inevitably => inevitably
infamous => infamous
infant => infant
infect => infect
infer => infer
inflation => inflation
inflict => inflict
influential => influential
info => info
inform => inform
information => information
infrastructure => infrastructure
ingredient => ingredient
ingredients => ingredient
inhabitant => inhabitant
inherent => inherent
inherit => inherit
inhibit => inhibit
initial => initial
initials => initial
initiate => initiate
inject => inject
injection => injection
injure => injure
injustice => injustice
ink => ink
inmate => inmate
innovation => innovation
innovative => innovative
input => input
inquiry => inquiry
insect => insect
insert => insert
insertion => insertion
inside => inside
insider => insider
insist => insist
inspect => inspect
inspection => inspection
inspector => inspector
inspiration => inspiration
install => install
installation => installation
instance => instance
instant => instant
instantly => instantly
instead => instead
instinct => instinct
institutional => institutional
instruct => instruct
instructions => instruction
instructor => instructor
instrument => instrument
instrumental => instrumental
insufficient => insufficient
insult => insult
int => int
intact => intact
intake => intake
integral => integral
integrate => integrate
integrated => integrate
integration => integration
integrity => integrity
intellectual => intellectual
intelligent => intelligent
intend => intend
intensify => intensify
intensity => intensity
intensive => intensive
intent => intent
interact => interact
interaction => interaction
interactive => interactive
interest => interest
interested => interested
interesting => interesting
interface => interface
interfere => interfere
interference => interference
interim => interim
interior => interior
intermediate => intermediate
international => international
internet => internet
interpretation => interpretation
interrogative => interrogative
interrupt => interrupt
interval => interval
intervene => intervene
intervention => intervention
interview => interview
intimate => intimate
into => into
intriguing => intriguing
introduce => introduce
introduction => introduction
invade => invade
invasion => invasion
invent => invent
invention => invention
investigator => investigator
investor => investor
invisible => invisible
invitation => invitation
invite => invite
invoke => invoke
involve => involve
involvement => involvement
iron => iron
ironic => ironic
ironically => ironically
ironing => ironing
irony => irony
irrelevant => irrelevant
is => be
island => island
isnâ€™t => isnâ€™t
isolate => isolate
isolated => isolate
isolation => isolation
issue => issue
it => it
item => item
its => it
itself => itself
itâ€™s => itâ€™s
jacket => jacket
jail => jail
jam => jam
jar => jar
jazz => jazz
jealous => jealous
jeans => jean
jellyfish => jellyfish
jet => jet
jewellery => jewellery
jewelry => jewelry
job => job
jockey => jockey
jog => jog
jogging => jogging
join => join
joint => joint
joke => joke
journalism => journalism
journalist => journalist
journey => journey
judge => judge
judicial => judicial
jug => jug
juice => juice
jump => jump
jumper => jumper
junction => junction
jungle => jungle
jurisdiction => jurisdiction
jury => jury
just => just
justification => justification
kangaroo => kangaroo
keen => keen
keep => keep
keeper => keeper
keeps => keep
kept => keep
kettle => kettle
key => key
keyboard => keyboard
keys => key
kg => kg
kick => kick
kid => kid
kidnap => kidnap
kidney => kidney
kids => kid
kill => kill
kilogram => kilogram
kilogramme => kilogramme
kilometer => kilometer
kilometre => kilometre
kilometres => kilometres
kind => kind
king => king
kingdom => kingdom
kiss => kiss
kit => kit
kitchen => kitchen
kite => kite
kitten => kitten
kiwi => kiwi
km => km
knee => knee
knife => knife
knit => knit
knock => knock
knocked => knock
know => know
knowledge => knowledge
known => know
lab => lab
label => label
laboratory => laboratory
lack => lack
lad => lad
ladder => ladder
lady => lady
lake => lake
lamb => lamb
lamp => lamp
land => land
landing => land
landlord => landlord
landmark => landmark
landscape => landscape
lane => lane
language => language
lap => lap
laptop => laptop
large => large
large-scale => large-scale
laser => laser
last => last
late => late
lately => lately
later => later
latest => late
latter => latter
laugh => laugh
law => law
lawn => lawn
lawsuit => lawsuit
lawyer => lawyer
lay => lay
layer => layer
layout => layout
lazy => lazy
lead => lead
leader => leader
leaf => leaf
leaf/leaves => leaf/leaves
leaflet => leaflet
league => league
leak => leak
leap => leap
learn => learn
least => least
leather => leather
leave => leave
leaves => leaf
leaves => leave
lecture => lecture
left => leave
left => left
left-hand => left-hand
leg => leg
legacy => legacy
legend => legend
legendary => legendary
legislation => legislation
legislative => legislative
legislature => legislature
legitimate => legitimate
leisure => leisure
lemon => lemon
lemonade => lemonade
lemons => lemon
lend => lend
length => length
lengthy => lengthy
lens => lens
lesbian => lesbian
less => less
lesser => less
lesson => lesson
let => let
lethal => lethal
letter => letter
lettuce => lettuce
letâ€™s => letâ€™s
level => level
liable => liable
liberal => liberal
liberation => liberation
liberty => liberty
library => library
licence => licence
license => license
lie => lie
life => life
lifelong => lifelong
lifetime => lifetime
lift => lift
light => light
lighter => lighter
lighting => light
lightning => lightning
lights => light
like => like
like/as => like/as
likelihood => likelihood
likely => likely
likewise => likewise
limb => limb
lime => lime
limit => limit
limitation => limitation
limited => limit
limited => limited
line => line
line-up => line-up
linear => linear
linger => linger
link => link
lion => lion
lip => lip
liquid => liquid
list => list
listen => listen
listing => list
liter => liter
literacy => literacy
literally => literally
literary => literary
literature => literature
litre => litre
litter => litter
little => little
live => live
lively => lively
liver => liver
living => living
lizard => lizard
load => load
loan => loan
lobby => lobby
local => local
locate => locate
located => locate
location => location
lock => lock
locker => locker
log => log
logic => logic
logo => logo
lonely => lonely
long => long
long-standing => long-standing
long-time => long-time
look => look
looking => look
looks => look
loom => loom
loop => loop
loose => loose
lorry => lorry
lose => lose
lost => lose
lot => lot
lots => lot
lottery => lottery
loud => loud
loudly => loudly
love => love
lovely => lovely
low => low
loyal => loyal
loyalty => loyalty
luck => luck
lucky => lucky
luggage => luggage
lunch => lunch
lunchtime => lunchtime
luxury => luxury
lyric => lyric
machine => machine
machinery => machinery
mad => mad
made => make
magazine => magazine
magic => magic
magical => magical
magistrate => magistrate
magnetic => magnetic
magnificent => magnificent
magnitude => magnitude
mail => mail
main => main
mainland => mainland
mainstream => mainstream
maintenance => maintenance
make => make
make-up => make-up
maker => maker
making => make
male => male
male/female => male/female
man => man
man/men => man/men
manage => manage
manager => manager
mandate => mandate
mandatory => mandatory
mango => mango
manifest => manifest
manipulate => manipulate
manipulation => manipulation
manufacture => manufacture
manufacturing => manufacture
manuscript => manuscript
many => many
map => map
marathon => marathon
march => march
margin => margin
marginal => marginal
marine => marine
mark => mark
marker => marker
market => market
marketplace => marketplace
marriage => marriage
married => marry
marry => marry
martial => martial
marvellous => marvellous
mask => mask
massacre => massacre
mat => mat
match => match
matches => match
mate => mate
material => material
math => math
mathematical => mathematical
mathematics => mathematics
maths => math
maths/mathematics => maths/mathematics
matter => matter
mature => mature
maximize => maximize
maximum => maximum
may => may
maybe => maybe
mayor => mayor
me => me
meal => meal
meals => meal
mean => mean
meaning => meaning
meaningful => meaningful
meantime => meantime
meanwhile => meanwhile
meat => meat
meatballs => meatball
mechanic => mechanic
mechanical => mechanical
mechanism => mechanism
medal => medal
medication => medication
medicine => medicine
medieval => medieval
meditation => meditation
medium => medium
meet => meet
meeting => meeting
melody => melody
melon => melon
member => member
membership => membership
memo => memo
memoir => memoir
memorable => memorable
memorial => memorial
memories => memory
memory => memory
mend => mend
mention => mention
mentor => mentor
menu => menu
merchant => merchant
mercy => mercy
mere => mere
merely => merely
merge => merge
merger => merger
merit => merit
mess => mess
message => message
messy => messy
metal => metal
metaphor => metaphor
meter => meter
method => method
methodology => methodology
methods => method
metre => metre
microwave => microwave
midday => midday
middle => middle
middle-aged => middle-aged
midnight => midnight
midst => midst
might => might
migration => migration
mild => mild
mile => mile
militant => militant
militia => militia
milk => milk
milkshake => milkshake
mill => mill
millimeter => millimeter
millimetre => millimetre
million => million
mind => mind
minding => mind
mine => mine
miner => miner
mineral => mineral
minimal => minimal
minimize => minimize
minimum => minimum
mining => mining
ministry => ministry
minus => minus
minute => minute
minutes => minute
miracle => miracle
mirror => mirror
miserable => miserable
misery => misery
misleading => mislead
miss => miss
missile => missile
missing => miss
mistake => mistake
mix => mix
mm => mm
mob => mob
mobile => mobile
mobility => mobility
mobilize => mobilize
mode => mode
model => model
moderate => moderate
modern => modern
modest => modest
modification => modification
moment => moment
momentum => momentum
money => money
money/time => money/time
monk => monk
monkey => monkey
monopoly => monopoly
monster => monster
month => month
monthly => monthly
monument => monument
mood => mood
moon => moon
morality => morality
more => more
moreover => moreover
morning => morning
mortgage => mortgage
mosque => mosque
mosquito => mosquito
most => most
mother => mother
motion => motion
motivate => motivate
motivation => motivation
motive => motive
motor-racing => motor-racing
motorbike => motorbike
motorcycle => motorcycle
motorist => motorist
motorway => motorway
mountain => mountain
mouse => mouse
mouse/mice => mouse/mice
moustache => moustache
mouth => mouth
move => move
movie => movie
moving => move
much => much
mug => mug
multiply => multiply
mum => mum
municipal => municipal
museum => museum
mushroom => mushroom
music => music
music/sport => music/sport
musical => musical
musician => musician
must => must
mutual => mutual
mv => mv
my => my
myself => myself
mystery => mystery
myth => myth
n => n
n't => n't
n. => n.
naked => naked
name => name
namely => namely
narrow => narrow
nasty => nasty
national => national
nationality => nationality
nationwide => nationwide
natural => natural
nature => nature
naughty => naughty
naval => naval
navigation => navigation
navy => navy
near => near
nearby => nearby
nearly => nearly
neat => neat
necessary => necessary
necessity => necessity
neck => neck
necklace => necklace
need => need
negative => negative
neglect => neglect
negotiate => negotiate
negotiation => negotiation
neighbour => neighbour
neighbourhood => neighbourhood
neighbouring => neighbour
nephew => nephew
nervous => nervous
nest => nest
net => net
network => network
neutral => neutral
never => never
new => new
newly => newly
news => news
newsletter => newsletter
newspaper => newspaper
next => next
nice => nice
niche => niche
niece => niece
night => night
nightclub => nightclub
nightlife => nightlife
nightmare => nightmare
no => no
noble => noble
nobody => nobody
nod => nod
noise => noise
noisy => noisy
nominate => nominate
nomination => nomination
nominee => nominee
non-profit => non-profit
none => none
nonetheless => nonetheless
nonsense => nonsense
noodles => noodle
noon => noon
norm => norm
normal => normal
normally => normally
north => north
northeast => northeast
northern => northern
northwest => northwest
nose => nose
not => not
notable => notable
notably => notably
note => note
notebook => notebook
notepaper => notepaper
notes => note
nothing => nothing
notice => notice
noticeboard => noticeboard
notify => notify
notorious => notorious
noun => noun
novel => novel
novelist => novelist
now => now
nowadays => nowadays
nowhere => nowhere
number => number
numbers => number
nurse => nurse
nursery => nursery
nursing => nursing
nutrition => nutrition
o'clock => o'clock
obesity => obesity
object => object
objection => objection
oblige => oblige
observer => observer
obsess => ob
obsession => obsession
obstacle => obstacle
obvious => obvious
obviously => obviously
occasion => occasion
occasional => occasional
occupation => occupation
occupy => occupy
occurrence => occurrence
ocean => ocean
odds => odds
of => of
of/from/out => of/from/out
off => off
offender => offender
offer => offer
offering => offer
office => office
officer => officer
offspring => offspring
often => often
oh => oh
oil => oil
old => old
old-fashioned => old-fashioned
olive => olive
omelette => omelette
on => on
on/upon => on/upon
once => once
one => one
one-way => one-way
ongoing => ongoing
onion => onion
online => online
only => only
onto => onto
open => open
opening => opening
openly => openly
opera => opera
operate => operate
operation => operation
operational => operational
operator => operator
opinion => opinion
opportunity => opportunity
opposite => opposite
opt => opt
optical => optical
optimism => optimism
optimistic => optimistic
option => option
or => or
oral => oral
orange => orange
oranges => orange
orchestra => orchestra
order => order
ordinary => ordinary
organic => organic
organisation => organisation
organise => organise
organizational => organizational
orientation => orientation
original => original
originate => originate
other => other
otherwise => otherwise
ought => ought
our => our
ours => ours
ourselves => ourselves
out => out
outbreak => outbreak
outdoor => outdoor
outdoors => outdoors
outer => outer
outfit => outfit
outing => out
outlet => outlet
outlook => outlook
output => output
outrage => outrage
outside => outside
outsider => outsider
outstanding => outstanding
oven => oven
over => over
over- => over-
overcome => overcome
overlook => overlook
overly => overly
overnight => overnight
overseas => overseas
oversee => oversee
overturn => overturn
overwhelm => overwhelm
overwhelming => overwhelming
owe => owe
own => own
owner => owner
ownership => ownership
oxygen => oxygen
oâ€™clock => oâ€™clock
p.m. => p.m.
pack => pack
packet => packet
pad => pad
page => page
pain => pain
painful => painful
paint => paint
painter => painter
painting => painting
pair => pair
palace => palace
pale => pale
palm => palm
pan => pan
pancake => pancake
panda => panda
panic => panic
pants => pant
paper => paper
papers => paper
parade => parade
paragraph => paragraph
parallel => parallel
parameter => parameter
parcel => parcel
pardon => pardon
parent => parent
parental => parental
parish => parish
park => park
parking => parking
parliamentary => parliamentary
parrot => parrot
part => part
part-time => part-time
partial => partial
partially => partially
participation => participation
particular => particular
partly => partly
partner => partner
partnership => partnership
party => party
pass => pas
pass => pass
passed => pass
passenger => passenger
passing => pass
passionate => passionate
passive => passive
passport => passport
password => password
past => past
pasta => pasta
pastor => pastor
patch => patch
patent => patent
path => path
pathway => pathway
patience => patience
patient => patient
patrol => patrol
patron => patron
pattern => pattern
pause => pause
pavement => pavement
pay => pay
pea => pea
peace => peace
peaceful => peaceful
peach => peach
peak => peak
peanut => peanut
pear => pear
peas => pea
peasant => peasant
peculiar => peculiar
pedestrian => pedestrian
peel => peel
peer => peer
pen => pen
penalty => penalty
pence => penny
pencil => pencil
penfriend => penfriend
penguin => penguin
penny => penny
people => people
pepper => pepper
peppers => pepper
per => per
perceive => perceive
percent => percent
perception => perception
perfect => perfect
perform => perform
performance => performance
performer => performer
perfume => perfume
perhaps => perhaps
period => period
permanent => permanent
permanently => permanently
permission => permission
permit => permit
permitted => permit
persist => persist
persistent => persistent
person => person
person/people => person/people
personal => personal
personally => personally
personnel => personnel
persuade => persuade
pet => pet
petition => petition
petrol => petrol
petrol/bike => petrol/bike
pharmacy => pharmacy
philosopher => philosopher
philosophical => philosophical
phone => phone
photo => photo
photo/picture => photo/picture
photocopy => photocopy
photographer => photographer
photography => photography
photos => photo
phr => phr
phrase => phrase
physician => physician
physics => physic
pi => pi
piano => piano
pick => pick
picked => pick
picnic => picnic
picture => picture
pie => pie
piece => piece
pieces => piece
pig => pig
pile => pile
pill => pill
pillow => pillow
pilot => pilot
pin => pin
pineapple => pineapple
pink => pink
pioneer => pioneer
pipe => pipe
pipeline => pipeline
pirate => pirate
pit => pit
pity => pity
pizza => pizza
pl => pl
place => place
placement => placement
plain => plain
plan => plan
plane => plane
planet => planet
plans => plan
plant => plant
plastic => plastic
plate => plate
platform => platform
play => play
player => player
playground => playground
playing => play
plea => plea
plead => plead
pleasant => pleasant
please => please
pleased => please
pleased => pleased
pleasure => pleasure
pledge => pledge
plenty => plenty
plug => plug
plunge => plunge
plus => plus
pocket => pocket
poem => poem
poet => poet
poetry => poetry
point => point
polar => polar
pole => pole
police => police
policeman => policeman
polite => polite
political => political
politician => politician
politics => politics
poll => poll
pollution => pollution
pon => pon
pond => pond
pool => pool
poor => poor
pop => pop
popular => popular
population => population
port => port
portfolio => portfolio
portion => portion
portray => portray
position => position
positive => positive
poss => po
possessive => possessive
possibility => possibility
possible => possible
possibly => possibly
post => post
post-war => post-war
postage => postage
postcard => postcard
poster => poster
postman => postman
postpone => postpone
pot => pot
potato => potato
potentially => potentially
pound => pound
pour => pour
powder => powder
power => power
powerful => powerful
practice => practice
practise => practise
practitioner => practitioner
pray => pray
prayer => prayer
preach => preach
precede => precede
precedent => precedent
precious => precious
precise => precise
precisely => precisely
precision => precision
predator => predator
predecessor => predecessor
predict => predict
predictable => predictable
predominantly => predominantly
prefer => prefer
preference => preference
pregnancy => pregnancy
pregnant => pregnant
prejudice => prejudice
preliminary => preliminary
premier => premier
premise => premise
premium => premium
prep => prep
prep. => prep.
preparation => preparation
prepare => prepare
prepared => prepare
preposition => preposition
prescribe => prescribe
prescription => prescription
present => present
presentation => presentation
presently => presently
presents => present
preservation => preservation
preside => preside
presidency => presidency
president => president
presidential => presidential
press => press
prestigious => prestigious
presumably => presumably
presume => presume
pretty => pretty
prevail => prevail
prevalence => prevalence
prevent => prevent
prevention => prevention
previous => previous
previously => previously
prey => prey
price => price
prices => price
pride => pride
primarily => primarily
primary => primary
prince => prince
princess => princess
principal => principal
print => print
printer => printer
prior => prior
prison => prison
prisoner => prisoner
private => private
privatization => privatization
privilege => privilege
prize => prize
probability => probability
probable => probable
probably => probably
probe => probe
problem => problem
problematic => problematic
problems => problem
proceed => proceed
proceedings => proceeding
proceeds => proceeds
processing => process
processor => processor
proclaim => proclaim
produce => produce
product => product
productive => productive
productivity => productivity
profession => profession
professional => professional
professor => professor
profitable => profitable
profound => profound
program => program
programme => programme
programming => program
progress => progress
progressive => progressive
prohibit => prohibit
project => project
projection => projection
prominent => prominent
promise => promise
promising => promising
promote => promote
promotion => promotion
prompt => prompt
pron => pron
pronoun => pronoun
pronounce => pronounce
pronounced => pronounced
pronunciation => pronunciation
propaganda => propaganda
proper => proper
property => property
proportion => proportion
proposition => proposition
prosecute => prosecute
prosecution => prosecution
prosecutor => prosecutor
prospective => prospective
prosperity => prosperity
protect => protect
protective => protective
protein => protein
protester => protester
protocol => protocol
proud => proud
prove => prove
provide => provide
province => province
provincial => provincial
provision => provision
provoke => provoke
psychiatric => psychiatric
psychological => psychological
public => public
publicity => publicity
publish => publish
publishing => publish
pull => pull
pullover => pullover
pulse => pulse
pump => pump
punch => punch
punish => punish
punk => punk
pupil => pupil
puppy => puppy
pure => pure
purely => purely
purple => purple
purpose => purpose
purse => purse
pursuit => pursuit
push => push
put => put
puzzle => puzzle
pyjamas => pyjama
qualification => qualification
qualified => qualify
quality => quality
quantity => quantity
quarter => quarter
queen => queen
query => query
quest => quest
question => question
questionnaire => questionnaire
queue => queue
quick => quick
quickest => quick
quickly => quickly
quiet => quiet
quietly => quietly
quit => quit
quite => quite
quiz => quiz
quota => quota
rabbit => rabbit
race => race
raced => race
racial => racial
racism => racism
racist => racist
racket => racket
radar => radar
radiation => radiation
radical => radical
radio => radio
rage => rage
raid => raid
rail => rail
railway => railway
rain => rain
rainbow => rainbow
raincoat => raincoat
rainforest => rainforest
raining => rain
raise => raise
rally => rally
ran => run
random => random
rang => rang
range => range
ranking => rank
rap => rap
rape => rape
rare => rare
rarely => rarely
rat => rat
rate => rate
rather => rather
rating => rating
ratio => ratio
rational => rational
raw => raw
ray => ray
reach => reach
read => read
reader => reader
readily => readily
reading => reading
ready => ready
real => real
realise => realise
realised => realise
realistic => realistic
realization => realization
really => really
realm => realm
rear => rear
reason => reason
reasonable => reasonable
reasonably => reasonably
reasoning => reason
reassure => reassure
rebel => rebel
rebellion => rebellion
rebuild => rebuild
receipt => receipt
receive => receive
receiver => receiver
recent => recent
reception => reception
receptionist => receptionist
recession => recession
recipe => recipe
recipient => recipient
reckon => reckon
recognise => recognise
recognition => recognition
recommend => recommend
reconstruction => reconstruction
record => record
recording => recording
recount1 => recount1
recover => recover
recovery => recovery
recruit => recruit
recruitment => recruitment
recycle => recycle
recycled => recycle
recycling => recycling
red => red
reduce => reduce
referee => referee
referendum => referendum
reflection => reflection
reform => reform
refreshments => refreshment
refrigerator => refrigerator
refuge => refuge
refugee => refugee
refund => refund
refusal => refusal
refuse => refuse
regain => regain
regarding => regarding
regardless => regardless
regards => regard
regime => regime
region => region
register => register
registered => register
registration => registration
regret => regret
regular => regular
regulate => regulate
regulator => regulator
regulatory => regulatory
rehabilitation => rehabilitation
reign => reign
reinforce => reinforce
rejection => rejection
relation => relation
relationship => relationship
relative => relative
relax => relax
relaxation => relaxation
relaxed => relaxed
relevance => relevance
reliability => reliability
reliable => reliable
relieve => relieve
relieved => relieve
religion => religion
reluctant => reluctant
remain => remain
remainder => remainder
remains => remain
remarkable => remarkable
remarkably => remarkably
remedy => remedy
remember => remember
remind => remind
reminder => reminder
remote => remote
removal => removal
remove => remove
render => render
renew => renew
renowned => renowned
rent => rent
rental => rental
repair => repair
repeat => repeat
replace => replace
replacement => replacement
reply => reply
report => report
reportedly => reportedly
reporter => reporter
reporting => report
representation => representation
reproduce => reproduce
reproduction => reproduction
republic => republic
request => request
require => require
rescue => rescue
research => research
resemble => resemble
reservation => reservation
reserve => reserve
reside => reside
residence => residence
residential => residential
residue => residue
resign => resign
resignation => resignation
resistance => resistance
resolution => resolution
resort => resort
respect => respect
respective => respective
respectively => respectively
responsible => responsible
rest => rest
restaurant => restaurant
restoration => restoration
restore => restore
restraint => restraint
restrict => restrict
restriction => restriction
restâ€™ => restâ€™
result => result
resume => resume
retail => retail
retire => retire
retirement => retirement
retreat => retreat
retrieve => retrieve
return => return
returned => return
revelation => revelation
revenge => revenge
revenue => revenue
reverse => reverse
review => review
revise => revise
revision => revision
revival => revival
revive => revive
revolutionary => revolutionary
reward => reward
rhetoric => rhetoric
rice => rice
rich => rich
rid => rid
ride => ride
rider => rider
ridiculous => ridiculous
rifle => rifle
right => right
right-hand => right-hand
right/alright => right/alright
ring => ring
riot => riot
rip => rip
rise => rise
rises => rise
rising => rise
risky => risky
ritual => ritual
rival => rival
river => river
rivers => river
road => road
roast => roast
rob => rob
robbery => robbery
robot => robot
robust => robust
rock => rock
rocket => rocket
rod => rod
role => role
roll => roll
roller => roller
romance => romance
romantic => romantic
roof => roof
room => room
rose => rise
rotate => rotate
rotation => rotation
rough => rough
roughly => roughly
round => round
roundabout => roundabout
route => route
routine => routine
row => row
rubber => rubber
rubbish => rubbish
rude => rude
rug => rug
rugby => rugby
ruin => ruin
rule => rule
ruler => ruler
rules => rule
ruling => rule
rumour => rumour
run => run
runner => runner
runners => runner
running => running
s => s
sack => sack
sacred => sacred
sacrifice => sacrifice
sad => sad
safe => safe
safely => safely
said => say
sail => sail
sailing => sailing
saint => saint
sake => sake
salad => salad
salary => salary
sale => sale
salesman/saleswoman => salesman/saleswoman
salmon => salmon
salt => salt
same => same
sanction => sanction
sand => sand
sandal => sandal
sandwich => sandwich
satisfaction => satisfaction
satisfactory => satisfactory
satisfied => satisfy
sauce => sauce
saucepan => saucepan
saucer => saucer
sausage => sausage
save => save
sawhimdancing => sawhimdancing
say => say
scandal => scandal
scare => scare
scared => scar
scarf => scarf
scary => scary
scattered => scatter
scenario => scenario
scene => scene
scenery => scenery
sceptical => sceptical
scholar => scholar
scholarship => scholarship
school => school
schoolchild => schoolchild
schoolgirl => schoolgirl
science => science
scientific => scientific
scientist => scientist
scissors => scissors
scooter => scooter
scope => scope
score => score
scratch => scratch
scream => scream
screen => screen
screening => screen
screw => screw
scrutiny => scrutiny
sculpture => sculpture
sea => sea
seal => seal
search => search
seaside => seaside
season => season
seat => seat
seats => seat
second => second
second-hand => second-hand
secondary => secondary
seconds => second
secret => secret
secretary => secretary
section => section
secular => secular
security => security
see => see
seeker => seeker
seem => seem
seemingly => seemingly
seems => seem
seen => see
segment => segment
seize => seize
seldom => seldom
select => select
selective => selective
self-service => self-service
selfish => selfish
sell => sell
seminar => seminar
senator => senator
send => send
sensation => sensation
sense => sense
sensible => sensible
sensitivity => sensitivity
sentence => sentence
sentiment => sentiment
separate => separate
separation => separation
serial => serial
series => series
serious => serious
seriously => seriously
serve => serve
server => server
service => service
session => session
set => set
set-up => set-up
settlement => settlement
settler => settler
several => several
severely => severely
sew => sew
sex => sex
sexuality => sexuality
sexy => sexy
shade => shade
shadow => shadow
shake => shake
shall => shall
shame => shame
shampoo => shampoo
shape => shape
shaped => shape
share => share
shareholder => shareholder
shark => shark
sharp => sharp
shatter => shatter
shave => shave
she => she
shed => shed
sheep => sheep
sheer => sheer
sheet => sheet
sheets => sheet
shelf => shelf
shell => shell
shine => shine
shiny => shiny
ship => ship
shipping => ship
shirt => shirt
shock => shock
shocked => shock
shocking => shock
shocking => shocking
shoe => shoe
shoes => shoe
shoot => shoot
shop => shop
shopping => shop
shopping => shopping
shore => shore
short => short
short-term => short-term
shortage => shortage
shortly => shortly
shorts => short
should => should
shoulder => shoulder
shout => shout
show => show
shower => shower
shows => show
shrink => shrink
shrug => shrug
shut => shut
shy => shy
sibling => sibling
sick => sick
side => side
sigh => sigh
sight => sight
sightseeing => sightseeing
sign => sign
signal => signal
signature => signature
significance => significance
signpost => signpost
signs => sign
silence => silence
silent => silent
silk => silk
silly => silly
silver => silver
similar => similar
simple => simple
simulate => simulate
simulation => simulation
simultaneously => simultaneously
sin => sin
since => since
sincerely => sincerely
sing => sing
singer => singer
singing => singing
single => single
sink => sink
sir => sir
sister => sister
sit => sit
site => site
sitting => sit
sitting => sitting
situated => situate
situation => situation
six => six
sixty => sixty
size => size
skate => skate
skateboard => skateboard
skateboarding => skateboard
skateboarding => skateboarding
skates => skate
skating => skate
skating => skating
sketch => sketch
ski => ski
skiing => ski
skiing => skiing
skill => skill
skilled => skilled
skin => skin
skip => skip
skirt => skirt
skull => skull
sky => sky
slam => slam
slap => slap
slash => slash
slavery => slavery
sleep => sleep
sleeve => sleeve
slice => slice
slim => slim
slip => slip
slogan => slogan
slot => slot
slow => slow
slowly => slowly
small => small
smart => smart
smash => smash
smell => smell
smile => smile
smoke => smoke
smoking => smoking
smooth => smooth
snack => snack
snail => snail
snake => snake
snap => snap
snow => snow
snowboard => snowboard
snowboarding => snowboarding
so => so
so-called => so-called
so-so => so-so
soak => soak
soap => soap
soar => soar
soccer => soccer
sociable => sociable
social => social
socialist => socialist
society => society
sock => sock
sofa => sofa
soft => soft
software => software
soldier => soldier
sole => sole
solely => solely
solicitor => solicitor
solidarity => solidarity
solo => solo
solution => solution
solve => solve
some => some
somebody => somebody
somehow => somehow
someone => someone
someone/something => someone/something
something => something
something/someone => something/someone
sometime => sometime
sometimes => sometimes
somewhere => somewhere
son => son
song => song
song/music/star/group => song/music/star/group
songs => song
soon => soon
sophisticated => sophisticated
sore => sore
sorry => sorry
sort => sort
soul => soul
sound => sound
sounds => sound
soup => soup
sour => sour
south => south
southeast => southeast
southern => southern
southwest => southwest
souvenir => souvenir
sovereignty => sovereignty
space => space
spaces => space
spam => spam
span => span
spare => spare
spark => spark
sparkling => sparkle
sparkling => sparkling
speak => speak
speaker => speaker
special => special
specialize => specialize
specialized => specialize
specification => specification
specify => specify
specimen => specimen
spectacle => spectacle
spectacular => spectacular
spectator => spectator
spectrum => spectrum
speculate => speculate
speculation => speculation
speech => speech
speed => speed
spell => spell
spelling => spelling
spend => spend
sphere => sphere
spice => spice
spicy => spicy
spider => spider
spill => spill
spin => spin
spinach => spinach
spine => spine
spite => spite
split => split
spoil => spoil
spokesman => spokesman
spokesperson => spokesperson
spokeswoman => spokeswoman
sponsorship => sponsorship
spoon => spoon
sport => sport
sporting => sport
sports => sport
spot => spot
spotlight => spotlight
spouse => spouse
spring => spring
spy => spy
squad => squad
square => square
squash => squash
squeeze => squeeze
stab => stab
stability => stability
stabilize => stabilize
stadium => stadium
staff => staff
stage => stage
stair => stair
stairs => stair
stake => stake
stall => stall
stamp => stamp
stance => stance
stand => stand
standing => stand
star => star
stark => stark
stars => star
start => start
starve => starve
station => station
statistical => statistical
statue => statue
stay => stay
stayed => stay
steadily => steadily
steak => steak
steal => steal
steal/ => steal/
steam => steam
steep => steep
steer => steer
stem => stem
step => step
stepped => step
steps => step
stereotype => stereotype
sth => sth
stick => stick
sticky => sticky
still => still
stimulate => stimulate
stimulus => stimulus
stir => stir
stole => steal
stolen => steal
stomach => stomach
stomach-ache => stomach-ache
stone => stone
stop => stop
stopped => stop
stopped => stopped
storage => storage
store => store
storm => storm
story => story
straight => straight
straightforward => straightforward
strain => strain
strand => strand
strange => strange
strangely => strangely
stranger => stranger
strategic => strategic
strawberry => strawberry
stream => stream
street => street
strengthen => strengthen
stress => stress
stressed => stress
stressful => stressful
strict => strict
strictly => strictly
strike => strike
striking => strike
string => string
strip => strip
stripe => stripe
strive => strive
stroke => stroke
strong => strong
structural => structural
student => student
students => student
studies => study
studio => studio
study => study
stuff => stuff
stumble => stumble
stun => stun
stunning => stun
stupid => stupid
style => style
stylish => stylish
subject => subject
submission => submission
subscriber => subscriber
subscription => subscription
subsequent => subsequent
subsequently => subsequently
subsidy => subsidy
substantial => substantial
substantially => substantially
substitute => substitute
substitution => substitution
subtle => subtle
subtract => subtract
suburb => suburb
suburban => suburban
subway => subway
succeed => succeed
success => success
successful => successful
succession => succession
successive => successive
successor => successor
such => such
suck => suck
sudden => sudden
suddenly => suddenly
sue => sue
suffer => suffer
suffering => suffer
sufficient => sufficient
sufficiently => sufficiently
sugar => sugar
suggest => suggest
suggestion => suggestion
suicide => suicide
suit => suit
suitable => suitable
suitcase => suitcase
suite => suite
sum => sum
summer => summer
summit => summit
sun => sun
sunbathe => sunbathe
sunglasses => sunglasses
sunny => sunny
sunrise => sunrise
sunset => sunset
sunshine => sunshine
super => super
superb => superb
superior => superior
supermarket => supermarket
supervise => supervise
supervision => supervision
supervisor => supervisor
supper => supper
supplement => supplement
support => support
supporter => supporter
supportive => supportive
suppose => suppose
supposed => suppose
supposedly => supposedly
suppress => suppress
supreme => supreme
sure => sure
surf => surf
surface => surface
surfboard => surfboard
surfing => surfing
surge => surge
surgeon => surgeon
surgical => surgical
surname => surname
surplus => surplus
surprise => surprise
surprised => surprise
surprising => surprising
surrender => surrender
surround => surround
surrounded => surround
surveillance => surveillance
survival => survival
survivor => survivor
suspend => suspend
suspension => suspension
suspicion => suspicion
suspicious => suspicious
sustain => sustain
sustainable => sustainable
swallow => swallow
swam => swim
sweater => sweater
sweatshirt => sweatshirt
sweet => sweet
swim => swim
swimmer => swimmer
swimming => swim
swimming => swimming
swimming-pool => swimming-pool
swimsuit => swimsuit
swing => swing
switch => switch
sword => sword
symbolic => symbolic
sympathetic => sympathetic
sympathy => sympathy
syndrome => syndrome
synthesis => synthesis
system => system
systematic => systematic
table => table
table-cloth => table-cloth
tablet => tablet
tackle => tackle
tactic => tactic
tactical => tactical
tag => tag
tail => tail
take => take
takeaway => takeaway
takes => take
taking => take
talent => talent
talented => talented
talk => talk
talking => talk
tall => tall
tap => tap
taste => taste
tastes => taste
tasty => tasty
tax => tax
taxi => taxi
taxpayer => taxpayer
tea => tea
teach => teach
teacher => teacher
teachers => teacher
teacherâ€™s => teacherâ€™s
teaching => teach
teaching => teaching
team => team
tear => tear
technique => technique
technological => technological
technology => technology
teddy => teddy
teenager => teenager
teens => teen
telephone => telephone
television => television
television/TV => television/TV
tell => tell
temperature => temperature
temperatureâ€™s => temperatureâ€™s
temple => temple
temporarily => temporarily
temporary => temporary
tempt => tempt
ten-pound => ten-pound
tenant => tenant
tendency => tendency
tender => tender
tennis => tennis
tense => tense
tension => tension
tent => tent
tenure => tenure
term => term
terminal => terminal
terminate => terminate
terms => term
terrain => terrain
terrible => terrible
terribly => terribly
terrific => terrific
terrified => terrify
terrify => terrify
territory => territory
terror => terror
terrorism => terrorism
terrorist => terrorist
test => test
testify => testify
testimony => testimony
testing => test
text => text
textbook => textbook
texture => texture
than => than
thank => thank
thankfully => thankfully
thanks => thanks
that => that
the => the
theater => theater
theatre => theatre
theatrical => theatrical
theft => theft
their => their
theirs => theirs
them => them
themselves => themselves
then => then
thenâ€¦ => thenâ€¦
theology => theology
theoretical => theoretical
theque => theque
therapist => therapist
there => there
thereafter => thereafter
thereby => thereby
therefore => therefore
these => these
thesis => thesis
they => they
thick => thick
thief => thief
thin => thin
thing => thing
things => thing
think => think
thinking => think
third => third
thirsty => thirsty
this => this
thorough => thorough
thoroughly => thoroughly
those => those
though => though
thought => think
thought => thought
thought-provoking => thought-provoking
thoughtful => thoughtful
thoughts => thought
thread => thread
three => three
threshold => threshold
threw => throw
thrilled => thrill
thriller => thriller
thrive => thrive
throat => throat
through => through
throw => throw
thumb => thumb
thunder => thunder
thunderstorm => thunderstorm
tick => tick
ticket => ticket
tide => tide
tidy => tidy
tie => tie
tiger => tiger
tight => tight
tighten => tighten
tights => tights
till => till
timber => timber
time => time
timely => timely
times => time
timetable => timetable
timing => timing
tin => tin
tiny => tiny
tip => tip
tire => tire
tired => tire
tiring => tiring
tissue => tissue
title => title
to => to
toast => toast
tobacco => tobacco
today => today
toe => toe
together => together
toilet => toilet
told => tell
tolerance => tolerance
tolerate => tolerate
toll => toll
tomato => tomato
tomorrow => tomorrow
ton => ton
tongue => tongue
tonight => tonight
tonne => tonne
too => too
took => take
tooth => tooth
tooth/teeth => tooth/teeth
toothache => toothache
toothbrush => toothbrush
toothpaste => toothpaste
top => top
topic => topic
torture => torture
toss => toss
total => total
totally => totally
touch => touch
tour => tour
tourism => tourism
tourist => tourist
tournament => tournament
toward => toward
towel => towel
tower => tower
town => town
town/city => town/city
toxic => toxic
toy => toy
trace => trace
track => track
tracksuit => tracksuit
tractor => tractor
trade => trade
trademark => trademark
trading => trading
traditional => traditional
traffic => traffic
tragedy => tragedy
tragic => tragic
trail => trail
trailer => trailer
train => train
trainer => trainer
trainers => trainer
training => training
trains => train
trait => trait
tram => tram
transaction => transaction
transcript => transcript
transfer => transfer
transformation => transformation
transit => transit
translate => translate
translation => translation
transmission => transmission
transmit => transmit
transparency => transparency
transparent => transparent
transport => transport
transportation => transportation
trap => trap
trash => trash
trauma => trauma
travel => travel
treasure => treasure
treat => treat
treaty => treaty
tree => tree
tremendous => tremendous
trend => trend
tribal => tribal
tribe => tribe
tribunal => tribunal
tribute => tribute
trick => trick
trigger => trigger
trillion => trillion
trio => trio
trip => trip
triumph => triumph
troop => troop
trophy => trophy
trouble => trouble
troubled => trouble
trousers => trouser
truck => truck
true => true
trumpet => trumpet
trunk => trunk
trust => trust
trustee => trustee
truth => truth
try => try
tsunami => tsunami
tube => tube
tuition => tuition
tuna => tuna
tune => tune
tunnel => tunnel
turkey => turkey
turn => turn
turned => turn
turning => turn
turning => turning
turnout => turnout
turnover => turnover
twenty => twenty
twice => twice
twin => twin
twist => twist
two => two
two-night => two-night
type => type
typical => typical
typically => typically
tyre => tyre
ugly => ugly
ultimate => ultimate
umbrella => umbrella
unable => unable
unacceptable => unacceptable
unbelievable => unbelievable
uncertainty => uncertainty
uncle => uncle
uncomfortable => uncomfortable
under => under
undergo => undergo
undergraduate => undergraduate
underground => underground
underline => underline
underlying => underlie
undermine => undermine
underneath => underneath
underpants => underpants
understand => understand
undertake => undertake
underwear => underwear
undoubtedly => undoubtedly
undress => undress
undressed => undressed
unemployed => unemployed
unemployment => unemployment
unexpected => unexpected
unfair => unfair
unfit => unfit
unfold => unfold
unforgettable => unforgettable
unfortunate => unfortunate
unfortunately => unfortunately
unfriendly => unfriendly
unhappy => unhappy
unhealthy => unhealthy
uniform => uniform
unify => unify
unimportant => unimportant
uninterested => uninterested
uninteresting => uninteresting
union => union
unit => unit
unite => unite
unity => unity
universal => universal
universe => universe
university => university
unkind => unkind
unknown => unknown
unless => unless
unlikey => unlikey
unlucky => unlucky
unmarried => unmarried
unnecessary => unnecessary
unpack => unpack
unpleasant => unpleasant
unprecedented => unprecedented
until => until
unusual => unusual
unveil => unveil
unwell => unwell
up => up
upcoming => upcoming
update => update
upgrade => upgrade
uphold => uphold
upload => upload
upon => upon
upper => upper
upset => upset
upstairs => upstairs
urgent => urgent
urgently => urgently
us => u
usage => usage
use => use
used => use
useful => useful
useless => useless
user => user
using => use
usual => usual
usually => usually
utility => utility
utilize => utilize
utterly => utterly
v => v
v. => v.
v/versus => v/versus
vacuum => vacuum
vague => vague
valid => valid
validity => validity
valley => valley
valuable => valuable
value => value
van => van
vanilla => vanilla
vanish => vanish
variable => variable
variation => variation
varied => varied
variety => variety
various => various
vase => vase
vegetable => vegetable
vegetarian => vegetarian
vehicle => vehicle
vein => vein
venture => venture
verb => verb
verbal => verbal
verdict => verdict
verify => verify
verse => verse
versus => versus
vertical => vertical
very => very
vessel => vessel
vet => vet
veteran => veteran
via => via
viable => viable
vibrant => vibrant
vice => vice
vicious => vicious
video => video
view => view
viewpoint => viewpoint
village => village
villager => villager
violate => violate
violation => violation
violin => violin
virtue => virtue
virus => virus
visa => visa
visible => visible
visit => visit
visited => visit
visitor => visitor
vocabulary => vocabulary
vocal => vocal
voice => voice
volleyball => volleyball
volume => volume
voluntary => voluntary
vote => vote
voting => vote
vow => vow
vowel => vowel
vulnerability => vulnerability
vulnerable => vulnerable
wage => wage
wait => wait
waiter => waiter
waiting => wait
waitress => waitress
wake => wake
walk => walk
walked => walk
walking => walk
walking => walking
wall => wall
wallet => wallet
wander => wander
want => want
wanted => want
war => war
ward => ward
wardrobe => wardrobe
warehouse => warehouse
warfare => warfare
warm => warm
warming => warm
warming => warming
warn => warn
warning => warning
warrant => warrant
warrior => warrior
was => be
wash => wash
washing => wash
washing-up => washing-up
waste => waste
watch => watch
watched => watch
water => water
waterfall => waterfall
watermelon => watermelon
wave => wave
waves => wave
way => way
we => we
weak => weak
weaken => weaken
wear => wear
wearing => wear
weather => weather
weave => weave
web => web
webcam => webcam
website => website
wedding => wedding
weed => weed
week => week
weekday => weekday
weekend => weekend
weekly => weekly
weeks => week
weigh => weigh
weight => weight
weird => weird
welcome => welcome
welfare => welfare
well => well
well-being => well-being
well-dressed => well-dressed
well-known => well-known
well-made => well-made
went => go
were => be
west => west
western => western
wet => wet
whale => whale
what => what
whatever => whatever
whatsoever => whatsoever
wheat => wheat
wheel => wheel
wheelchair => wheelchair
wheels => wheel
when => when
whenever => whenever
where => where
whereby => whereby
wherever => wherever
whether => whether
which => which
while => while
whilst => whilst
whip => whip
white => white
who => who
whoever => whoever
whole => whole
wholly => wholly
whose => whose
why => why
wide => wide
widen => widen
widespread => widespread
widow => widow
width => width
wife => wife
wild => wild
wildlife => wildlife
will => will
willing => willing
willingness => willingness
win => win
wind => wind
window => window
windscreen => windscreen
windsurfing => windsurfing
windy => windy
wing => wing
winner => winner
winter => winter
wipe => wipe
wisdom => wisdom
wise => wise
wish => wish
wishes => wish
wit => wit
with => with
with/together => with/together
withdraw => withdraw
withdrawal => withdrawal
within => within
without => without
wo => wo
woman => woman
woman/women => woman/women
won => win
wonder => wonder
wonderful => wonderful
wood => wood
wooden => wooden
wool => wool
word => word
wordlist => wordlist
words => word
work => work
worker => worker
workforce => workforce
working => work
workout => workout
workplace => workplace
workshop => workshop
world => world
worm => worm
worn => wear
worried => worry
worry => worry
worse => bad
worse => worse
worship => worship
worst => bad
worth => worth
worthwhile => worthwhile
worthy => worthy
would => would
wow => wow
wrap => wrap
wrist => wrist
write => write
writer => writer
writing => write
writing => writing
written => write
wrong => wrong
yard => yard
yeah => yeah
year => year
yell => yell
yellow => yellow
yes => yes
yesterday => yesterday
yet => yet
yield => yield
yoga => yoga
yoghurt => yoghurt
you => you
young => young
younger => young
youngster => youngster
your => your
yours => yours
yourself => yourself
youth => youth
youâ€™re => youâ€™re
zebra => zebra
zero => zero
zone => zone
zoo => zoo
Â£ => Â£
Â£10.00 => Â£10.00
Â£26 => Â£26
Â£3 => Â£3
Â© => Â©
â€ => â€
â€¢ => â€¢
â€˜Try => â€˜Try
ï‚· => ï‚·
“ => “